,Unnamed: 0,District,Democratic,Republican,Year,State,total,Majority
0,0,1,89226,153228,2018,AL,242454,121228
1,1,2,86931,138879,2018,AL,225810,112906
2,2,3,83996,147770,2018,AL,231766,115884
3,3,4,46492,184255,2018,AL,230747,115374
4,4,5,101388,159063,2018,AL,260451,130226
5,5,6,85644,192542,2018,AL,278186,139094
6,6,7,185010,0,2018,AL,185010,92506
7,8,1,143240,122784,2018,AK,266024,133013
8,9,2,161000,133083,2018,AZ,294083,147042
9,10,3,114650,64868,2018,AZ,179518,89760
10,11,4,84521,188842,2018,AZ,273363,136682
11,12,5,127027,186037,2018,AZ,313064,156533
12,13,6,140559,173140,2018,AZ,313699,156850
13,14,7,113044,0,2018,AZ,113044,56523
14,15,8,135569,168835,2018,AZ,304404,152203
15,16,9,159583,101662,2018,AZ,261245,130623
16,19,1,57907,138757,2018,AZ,196664,98333
17,20,2,116135,132125,2018,AR,248260,124131
18,21,3,74952,148717,2018,AR,223669,111835
19,22,4,63984,136740,2018,AR,200724,100363
20,24,1,131548,160046,2018,AR,291594,145798
21,25,1,220133,130845,2018,CA,350978,175490
22,26,2,243081,72576,2018,CA,315657,157829
23,27,3,134875,97376,2018,CA,232251,116126
24,28,4,156253,184401,2018,CA,340654,170328
25,29,5,205860,0,2018,CA,205860,102931
26,30,6,201939,0,2018,CA,201939,100970
27,31,7,155016,126601,2018,CA,281617,140809
28,32,8,0,170785,2018,CA,170785,85393
29,33,9,113414,87349,2018,CA,200763,100382
30,34,10,115945,105955,2018,CA,221900,110951
31,35,11,204369,71312,2018,CA,275681,137841
32,36,12,275292,41780,2018,CA,317072,158537
33,37,13,260580,0,2018,CA,260580,130291
34,38,14,211384,55439,2018,CA,266823,133412
35,39,15,177989,65940,2018,CA,243929,121965
36,40,16,82266,60693,2018,CA,142959,71480
37,41,17,159105,52057,2018,CA,211162,105582
38,42,18,225142,77096,2018,CA,302238,151120
39,43,19,162496,57823,2018,CA,220319,110160
40,44,20,183677,0,2018,CA,183677,91839
41,45,21,57239,56377,2018,CA,113616,56809
42,46,22,105136,117243,2018,CA,222379,111190
43,47,23,74661,131113,2018,CA,205774,102888
44,48,24,166550,117881,2018,CA,284431,142216
45,49,25,133209,111813,2018,CA,245022,122512
46,50,26,158216,97210,2018,CA,255426,127714
47,51,27,202636,0,2018,CA,202636,101319
48,52,28,196662,54272,2018,CA,250934,125468
49,53,29,124697,29995,2018,CA,154692,77347
50,54,30,191573,69420,2018,CA,260993,130497
51,55,31,110143,77352,2018,CA,187495,93748
52,56,32,121759,55272,2018,CA,177031,88516
53,57,33,219091,93769,2018,CA,312860,156431
54,58,34,110195,0,2018,CA,110195,55098
55,59,35,103420,45604,2018,CA,149024,74513
56,60,36,122169,84839,2018,CA,207008,103505
57,61,37,210555,25823,2018,CA,236378,118190
58,62,38,139188,62968,2018,CA,202156,101079
59,63,39,126002,118391,2018,CA,244393,122197
60,64,40,93938,0,2018,CA,93938,46970
61,65,41,108227,58021,2018,CA,166248,83125
62,66,42,100892,131040,2018,CA,231932,115967
63,67,43,152272,43780,2018,CA,196052,98027
64,68,44,143322,0,2018,CA,143322,71662
65,69,45,158906,146383,2018,CA,305289,152645
66,70,46,102278,45638,2018,CA,147916,73959
67,71,47,143354,77682,2018,CA,221036,110519
68,72,48,157837,136899,2018,CA,294736,147369
69,73,49,166453,128577,2018,CA,295030,147516
70,74,50,125448,134362,2018,CA,259810,129906
71,75,51,109527,44301,2018,CA,153828,76915
72,76,52,188992,107015,2018,CA,296007,148004
73,77,53,185667,83127,2018,CA,268794,134398
74,80,1,272886,85207,2018,CO,358093,179047
75,81,2,259608,144901,2018,CO,404509,202255
76,82,3,146426,173205,2018,CO,319631,159816
77,83,4,145544,224038,2018,CO,369582,184792
78,84,5,126848,184002,2018,CO,310850,155426
79,85,6,187639,148685,2018,CO,336324,168163
80,86,7,204260,119734,2018,CO,323994,161998
81,88,1,166155,96024,2018,CT,262179,131090
82,89,2,167659,102483,2018,CT,270142,135072
83,90,3,163211,95667,2018,CT,258878,129440
84,91,4,168726,103175,2018,CT,271901,135951
85,92,5,142901,115146,2018,CT,258047,129024
86,95,1,227353,125384,2018,DE,352737,176369
87,97,1,106199,216189,2018,FL,322388,161195
88,98,2,96233,199335,2018,FL,295568,147785
89,99,3,129880,176616,2018,FL,306496,153249
90,100,4,123351,248420,2018,FL,371771,185886
91,101,5,180527,89799,2018,FL,270326,135164
92,102,6,145758,187891,2018,FL,333649,166825
93,103,7,183113,134285,2018,FL,317398,158700
94,104,8,142415,218112,2018,FL,360527,180264
95,105,9,172172,124565,2018,FL,296737,148369
96,106,10,1,0,2018,FL,1,1
97,107,11,128053,239395,2018,FL,367448,183725
98,108,12,132844,194564,2018,FL,327408,163705
99,109,13,182717,134254,2018,FL,316971,158486
100,110,14,1,0,2018,FL,1,1
101,111,15,134132,151380,2018,FL,285512,142757
102,112,16,164463,197483,2018,FL,361946,180974
103,113,17,117194,193326,2018,FL,310520,155261
104,114,18,156454,185905,2018,FL,342359,171180
105,115,19,128106,211465,2018,FL,339571,169786
106,116,20,202659,0,2018,FL,202659,101330
107,117,21,1,0,2018,FL,1,1
108,118,22,184634,113049,2018,FL,297683,148842
109,119,23,161611,99446,2018,FL,261057,130529
110,120,24,1,0,2018,FL,1,1
111,121,25,84173,128672,2018,FL,212845,106423
112,122,26,119797,115678,2018,FL,235475,117738
113,123,27,130743,115588,2018,FL,246331,123166
114,126,1,105942,144741,2018,GA,250683,125342
115,127,2,136699,92472,2018,GA,229171,114586
116,128,3,101010,191996,2018,GA,293006,146504
117,129,4,227717,61092,2018,GA,288809,144405
118,130,5,275406,0,2018,GA,275406,137704
119,131,6,160139,156875,2018,GA,317014,158508
120,132,7,140011,140430,2018,GA,280441,140221
121,133,8,0,198152,2018,GA,198152,99077
122,134,9,57912,224661,2018,GA,282573,141287
123,135,10,112339,190396,2018,GA,302735,151368
124,136,11,118653,191887,2018,GA,310540,155271
125,137,12,101503,148986,2018,GA,250489,125245
126,138,13,223157,69760,2018,GA,292917,146459
127,139,14,53981,175743,2018,GA,229724,114863
128,141,1,134650,42498,2018,GA,177148,88575
129,142,2,153271,44850,2018,GA,198121,99061
130,145,1,96922,197719,2018,ID,294641,147321
131,146,2,110381,170274,2018,ID,280655,140328
132,148,1,189560,50960,2018,IL,240520,120261
133,149,2,190684,44567,2018,IL,235251,117626
134,150,3,163053,57885,2018,IL,220938,110470
135,151,4,143895,22294,2018,IL,166189,83095
136,152,5,213992,65134,2018,IL,279126,139564
137,153,6,169001,146445,2018,IL,315446,157724
138,154,7,215746,30497,2018,IL,246243,123122
139,155,8,130054,67073,2018,IL,197127,98564
140,156,9,213368,76983,2018,IL,290351,145176
141,157,10,156540,82124,2018,IL,238664,119333
142,158,11,145407,82358,2018,IL,227765,113883
143,159,12,118724,134884,2018,IL,253608,126805
144,160,13,134458,136516,2018,IL,270974,135488
145,161,14,156035,141164,2018,IL,297199,148600
146,162,15,74309,181294,2018,IL,255603,127802
147,163,16,104569,151254,2018,IL,255823,127912
148,164,17,142659,87090,2018,IL,229749,114875
149,165,18,95486,195927,2018,IL,291413,145707
150,167,1,159611,85594,2018,IN,245205,122603
151,168,2,103363,125499,2018,IN,228862,114432
152,169,3,86610,158927,2018,IN,245537,122769
153,170,4,87824,156539,2018,IN,244363,122182
154,171,5,137142,180035,2018,IN,317177,158589
155,172,6,79430,154260,2018,IN,233690,116846
156,173,7,141139,76457,2018,IN,217596,108799
157,174,8,86895,157396,2018,IN,244291,122146
158,175,9,118090,153271,2018,IN,271361,135681
159,178,1,170342,153442,2018,IA,323784,161893
160,179,2,171446,133287,2018,IA,304733,152367
161,180,3,175642,167933,2018,IA,343575,171788
162,181,4,147246,157676,2018,IA,304922,152462
163,183,1,71558,153082,2018,IA,224640,112321
164,184,2,123859,126098,2018,IA,249957,124979
165,185,3,170518,139762,2018,IA,310280,155141
166,186,4,98445,144248,2018,IA,242693,121347
167,188,1,78849,172167,2018,KY,251016,125509
168,189,2,79964,171700,2018,KY,251664,125833
169,190,3,173002,101930,2018,KY,274932,137467
170,191,4,90536,162946,2018,KY,253482,126742
171,192,5,45890,172093,2018,KY,217983,108992
172,193,6,144736,154468,2018,KY,299204,149603
173,195,1,71521,192555,2018,LA,264076,132039
174,196,2,190182,0,2018,LA,190182,95092
175,197,3,74713,168263,2018,LA,242976,121489
176,198,4,72934,139326,2018,LA,212260,106131
177,199,5,67118,149018,2018,LA,216136,108069
178,200,6,76716,186553,2018,LA,263269,131635
179,202,1,201195,111188,2018,ME,312383,156192
180,203,2,142440,138931,2018,ME,281371,140686
181,206,1,116631,183662,2018,MD,300293,150147
182,207,2,167201,77782,2018,MD,244983,122492
183,208,3,202407,82774,2018,MD,285181,142591
184,209,4,209642,53327,2018,MD,262969,131485
185,210,5,213796,82361,2018,MD,296157,148079
186,211,6,163346,105209,2018,MD,268555,134278
187,212,7,202345,56266,2018,MD,258611,129306
188,213,8,217679,96525,2018,MD,314204,157103
189,216,1,211790,0,2018,MA,211790,105896
190,217,2,191332,93391,2018,MA,284723,142362
191,218,3,173175,93445,2018,MA,266620,133311
192,219,4,245289,0,2018,MA,245289,122645
193,220,5,236243,74856,2018,MA,311099,155550
194,221,6,217703,104798,2018,MA,322501,161251
195,222,7,216557,0,2018,MA,216557,108279
196,223,8,259159,0,2018,MA,259159,129580
197,224,9,192347,131463,2018,MA,323810,161906
198,227,1,145246,187251,2018,MI,332497,166249
199,228,2,131254,168970,2018,MI,300224,150113
200,229,3,134185,169107,2018,MI,303292,151647
201,230,4,106540,178510,2018,MI,285050,142526
202,231,5,164502,99265,2018,MI,263767,131884
203,232,6,134082,147436,2018,MI,281518,140760
204,233,7,136330,158730,2018,MI,295060,147531
205,234,8,172880,159782,2018,MI,332662,166332
206,235,9,181734,112123,2018,MI,293857,146929
207,236,10,106061,182808,2018,MI,288869,144435
208,237,11,181912,158463,2018,MI,340375,170188
209,238,12,200588,85115,2018,MI,285703,142852
210,239,13,165355,0,2018,MI,165355,82678
211,240,14,214334,45899,2018,MI,260233,130117
212,243,1,0,144885,2018,MN,144885,72443
213,244,2,0,177958,2018,MN,177958,88980
214,245,3,0,202404,2018,MN,202404,101203
215,246,4,216865,0,2018,MN,216865,108433
216,247,5,0,267703,2018,MN,267703,133852
217,248,6,0,122332,2018,MN,122332,61167
218,249,7,146672,0,2018,MN,146672,73337
219,250,8,0,141950,2018,MN,141950,70976
220,253,1,76601,158245,2018,MS,234846,117424
221,254,2,158921,0,2018,MS,158921,79461
222,255,3,94461,160284,2018,MS,254745,127373
223,256,4,68787,152633,2018,MS,221420,110711
224,259,1,219781,45867,2018,MO,265648,132825
225,260,2,177611,192477,2018,MO,370088,185045
226,261,3,106589,211243,2018,MO,317832,158917
227,262,4,95968,190138,2018,MO,286106,143054
228,263,5,175019,101069,2018,MO,276088,138045
229,264,6,97660,199796,2018,MO,297456,148729
230,265,7,89190,196343,2018,MO,285533,142767
231,266,8,66151,194042,2018,MO,260193,130097
232,269,1,233284,256661,2018,MT,489945,244973
233,271,1,93069,141712,2018,NE,234781,117391
234,272,2,121770,126715,2018,NE,248485,124243
235,273,3,49654,163650,2018,NE,213304,106653
236,276,1,100707,46978,2018,NV,147685,73843
237,277,2,120102,167435,2018,NV,287537,143769
238,278,3,148501,122566,2018,NV,271067,135534
239,279,4,121962,102748,2018,NV,224710,112356
240,282,1,155884,130996,2018,NH,286880,143441
241,283,2,155358,117990,2018,NH,273348,136675
242,285,1,169628,87617,2018,NJ,257245,128623
243,286,2,136685,116866,2018,NJ,253551,126776
244,287,3,153473,149500,2018,NJ,302973,151487
245,288,4,126766,163065,2018,NJ,289831,144916
246,289,5,169546,128255,2018,NJ,297801,148901
247,290,6,140752,80443,2018,NJ,221195,110598
248,291,7,166985,150785,2018,NJ,317770,158886
249,292,8,119881,28725,2018,NJ,148606,74304
250,293,9,140832,57854,2018,NJ,198686,99344
251,294,10,175253,20191,2018,NJ,195444,97723
252,295,11,183684,136322,2018,NJ,320006,160004
253,296,12,173334,79041,2018,NJ,252375,126188
254,299,1,147336,90507,2018,NM,237843,118922
255,300,2,101489,97767,2018,NM,199256,99629
256,301,3,155201,76427,2018,NM,231628,115815
257,304,1,124213,121562,2018,NY,245775,122888
258,305,2,108803,112565,2018,NY,221368,110685
259,306,3,149937,98716,2018,NY,248653,124327
260,307,4,156728,90306,2018,NY,247034,123518
261,308,5,160500,0,2018,NY,160500,80251
262,309,6,104293,0,2018,NY,104293,52147
263,310,7,134125,0,2018,NY,134125,67063
264,311,8,170850,0,2018,NY,170850,85426
265,312,9,167269,18702,2018,NY,185971,92986
266,313,10,162131,33692,2018,NY,195823,97912
267,314,11,96850,80440,2018,NY,177290,88646
268,315,12,205858,30446,2018,NY,236304,118153
269,316,13,171341,9535,2018,NY,180876,90439
270,317,14,110318,19202,2018,NY,129520,64761
271,318,15,122007,4566,2018,NY,126573,63287
272,319,16,172815,0,2018,NY,172815,86408
273,320,17,159923,0,2018,NY,159923,79962
274,321,18,126368,96345,2018,NY,222713,111357
275,322,19,135582,112304,2018,NY,247886,123944
276,323,20,161330,89058,2018,NY,250388,125195
277,324,21,93394,116433,2018,NY,209827,104914
278,325,22,116001,110125,2018,NY,226126,113064
279,326,23,100914,114722,2018,NY,215636,107819
280,327,24,115902,113538,2018,NY,229440,114721
281,328,25,147979,91342,2018,NY,239321,119661
282,329,26,156968,61488,2018,NY,218456,109229
283,330,27,128167,114506,2018,NY,242673,121337
284,333,1,190457,82218,2018,NC,272675,136338
285,334,2,151977,170072,2018,NC,322049,161025
286,335,3,0,187901,2018,NC,187901,93951
287,336,4,247067,82052,2018,NC,329119,164560
288,337,5,120468,159917,2018,NC,280385,140193
289,338,6,123651,160709,2018,NC,284360,142181
290,339,7,120838,156809,2018,NC,277647,138824
291,340,8,114119,141402,2018,NC,255521,127761
292,341,9,0,0,2018,NC,0,1
293,342,10,113259,164969,2018,NC,278228,139115
294,343,11,116508,178012,2018,NC,294520,147261
295,344,12,203974,75164,2018,NC,279138,139570
296,345,13,130402,147570,2018,NC,277972,138987
297,347,1,0,193568,2018,ND,193568,96785
298,349,1,141118,154409,2018,OH,295527,147764
299,350,2,119333,166714,2018,OH,286047,143024
300,351,3,181575,65040,2018,OH,246615,123308
301,352,4,89412,167993,2018,OH,257405,128703
302,353,5,99655,176569,2018,OH,276224,138113
303,354,6,76716,172774,2018,OH,249490,124746
304,355,7,107536,153117,2018,OH,260653,130327
305,356,8,87281,173852,2018,OH,261133,130567
306,357,9,157219,74670,2018,OH,231889,115945
307,358,10,118785,157554,2018,OH,276339,138170
308,359,11,206138,44486,2018,OH,250624,125313
309,360,12,161251,175677,2018,OH,336928,168465
310,361,13,153323,98047,2018,OH,251370,125686
311,362,14,137549,169809,2018,OH,307358,153680
312,363,15,116112,170593,2018,OH,286705,143353
313,364,16,129681,170029,2018,OH,299710,149856
314,367,1,103042,150129,2018,OK,253171,126586
315,368,2,65021,140451,2018,OK,205472,102737
316,369,3,61152,172913,2018,OK,234065,117033
317,370,4,78088,149227,2018,OK,227315,113658
318,371,5,121149,117811,2018,OK,238960,119481
319,373,1,231198,116446,2018,OR,347644,173823
320,374,2,145298,207597,2018,OR,352895,176448
321,375,3,279019,76187,2018,OR,355206,177604
322,376,4,208710,152414,2018,OR,361124,180563
323,377,5,197187,149887,2018,OR,347074,173538
324,379,1,160745,169053,2018,PA,329798,164900
325,380,2,159600,42382,2018,PA,201982,100992
326,381,3,287610,20387,2018,PA,307997,153999
327,382,4,211524,121467,2018,PA,332991,166496
328,383,5,198639,106075,2018,PA,304714,152358
329,384,6,177704,124124,2018,PA,301828,150915
330,385,7,140813,114437,2018,PA,255250,127626
331,386,8,135603,112563,2018,PA,248166,124084
332,387,9,100204,148723,2018,PA,248927,124464
333,388,10,141668,149365,2018,PA,291033,145517
334,389,11,113876,163708,2018,PA,277584,138793
335,390,12,82825,161047,2018,PA,243872,121937
336,391,13,74733,178533,2018,PA,253266,126634
337,392,14,110051,151386,2018,PA,261437,130719
338,393,15,78327,165245,2018,PA,243572,121787
339,394,16,124109,135348,2018,PA,259457,129729
340,395,17,183162,142417,2018,PA,325579,162790
341,396,18,231472,0,2018,PA,231472,115737
342,399,1,116099,57567,2018,RI,173666,86834
343,400,2,126476,72271,2018,RI,198747,99374
344,403,1,145455,141473,2018,SC,286928,143465
345,404,2,109199,144642,2018,SC,253841,126921
346,405,3,70046,153338,2018,SC,223384,111693
347,406,4,89182,145321,2018,SC,234503,117252
348,407,5,103129,141757,2018,SC,244886,122444
349,408,6,144765,58282,2018,SC,203047,101524
350,409,7,96564,142681,2018,SC,239245,119623
351,411,1,121033,202695,2018,SD,323728,161865
352,412,1,47138,172835,2018,TN,219973,109987
353,413,2,86668,172856,2018,TN,259524,129763
354,414,3,84731,156512,2018,TN,241243,120622
355,415,4,78065,147323,2018,TN,225388,112695
356,416,5,177923,84317,2018,TN,262240,131121
357,417,6,70370,172810,2018,TN,243180,121591
358,418,7,81661,170071,2018,TN,251732,125867
359,419,8,74755,168030,2018,TN,242785,121393
360,420,9,145139,34901,2018,TN,180040,90021
361,423,1,61263,168165,2018,TX,229428,114715
362,424,2,119992,139188,2018,TX,259180,129591
363,425,3,138234,169520,2018,TX,307754,153878
364,426,4,57400,188667,2018,TX,246067,123034
365,427,5,78666,130617,2018,TX,209283,104642
366,428,6,116350,135961,2018,TX,252311,126156
367,429,7,127959,115642,2018,TX,243601,121801
368,430,8,67930,200619,2018,TX,268549,134275
369,431,9,136256,0,2018,TX,136256,68129
370,432,10,144034,157166,2018,TX,301200,150601
371,433,11,40631,176603,2018,TX,217234,108618
372,434,12,90994,172557,2018,TX,263551,131776
373,435,13,35083,169027,2018,TX,204110,102056
374,436,14,92212,138942,2018,TX,231154,115578
375,437,15,98333,63862,2018,TX,162195,81098
376,438,16,124437,49127,2018,TX,173564,86783
377,439,17,98070,134841,2018,TX,232911,116456
378,440,18,138704,38368,2018,TX,177072,88537
379,441,19,50039,151946,2018,TX,201985,100993
380,442,20,139038,0,2018,TX,139038,69520
381,443,21,168421,177654,2018,TX,346075,173038
382,444,22,138153,152750,2018,TX,290903,145452
383,445,23,102359,103285,2018,TX,205644,102823
384,446,24,125231,133317,2018,TX,258548,129275
385,447,25,136385,163023,2018,TX,299408,149705
386,448,26,121938,185551,2018,TX,307489,153745
387,449,27,75929,125118,2018,TX,201047,100524
388,450,28,117494,0,2018,TX,117494,58748
389,451,29,88188,28098,2018,TX,116286,58144
390,452,30,166784,0,2018,TX,166784,83393
391,453,31,136362,144680,2018,TX,281042,140522
392,454,32,144067,126101,2018,TX,270168,135085
393,455,33,90805,26120,2018,TX,116925,58463
394,456,34,85825,57243,2018,TX,143068,71535
395,457,35,138278,50553,2018,TX,188831,94416
396,458,36,60908,161048,2018,TX,221956,110979
397,461,1,63308,156692,2018,UT,220000,110001
398,462,2,105051,151489,2018,UT,256540,128271
399,463,3,70686,174856,2018,UT,245542,122772
400,464,4,134964,134270,2018,UT,269234,134618
401,469,1,148464,183250,2018,VA,331714,165858
402,470,2,139571,133458,2018,VA,273029,136515
403,471,3,198615,0,2018,VA,198615,99308
404,472,4,187642,107706,2018,VA,295348,147675
405,473,5,145040,165339,2018,VA,310379,155190
406,474,6,113133,167957,2018,VA,281090,140546
407,475,7,176079,169295,2018,VA,345374,172688
408,476,8,247137,76899,2018,VA,324036,162019
409,477,9,85833,160933,2018,VA,246766,123384
410,478,10,206356,160841,2018,VA,367197,183599
411,479,11,219191,83023,2018,VA,302214,151108
412,482,1,103637,192243,2018,VT,295880,147941
413,483,1,197209,135534,2018,WA,332743,166372
414,484,2,210187,0,2018,WA,210187,105094
415,485,3,145407,161819,2018,WA,307226,153614
416,486,4,83785,141551,2018,WA,225336,112669
417,487,5,144925,175422,2018,WA,320347,160174
418,488,6,206409,116677,2018,WA,323086,161544
419,489,7,329800,64881,2018,WA,394681,197341
420,490,8,164089,0,2018,WA,164089,82045
421,491,9,240567,0,2018,WA,240567,120284
422,492,10,166215,103860,2018,WA,270075,135038
423,495,1,70217,127997,2018,WV,198214,99108
424,496,2,88011,110504,2018,WV,198515,99258
425,497,3,76340,98645,2018,WV,174985,87493
426,500,1,137508,177492,2018,WI,315000,157501
427,501,2,309116,0,2018,WI,309116,154559
428,502,3,187888,126980,2018,WI,314868,157435
429,503,4,206487,59091,2018,WI,265578,132790
430,504,5,138385,225619,2018,WI,364004,182003
431,505,6,144536,180311,2018,WI,324847,162424
432,506,7,124307,194061,2018,WI,318368,159185
433,507,8,119265,209410,2018,WI,328675,164338
434,510,1,59903,127963,2018,WY,187866,93934
0,0,1,48278,103758,2014,AL,152036,76019
1,1,2,54692,113103,2014,AL,167795,83898
2,2,3,52816,103558,2014,AL,156374,78188
3,3,4,0,132831,2014,AL,132831,66416
4,4,5,0,115338,2014,AL,115338,57670
5,5,6,42291,135945,2014,AL,178236,89119
6,6,7,133687,0,2014,AL,133687,66844
7,9,1,114602,142572,2014,AK,257174,128588
8,11,1,97391,87723,2014,AZ,185114,92558
9,12,2,109543,109704,2014,AZ,219247,109624
10,13,3,58192,46185,2014,AZ,104377,52189
11,14,4,45179,122560,2014,AZ,167739,83870
12,15,5,54596,124867,2014,AZ,179463,89732
13,16,6,70198,129578,2014,AZ,199776,99889
14,17,7,54235,0,2014,AZ,54235,27118
15,18,8,0,128710,2014,AZ,128710,64356
16,19,9,88609,67841,2014,AZ,156450,78226
17,21,1,63555,124139,2014,AR,187694,93848
18,22,2,103477,123073,2014,AR,226550,113276
19,23,3,0,151630,2014,AR,151630,75816
20,24,4,87742,110789,2014,AR,198531,99266
21,27,1,84320,132052,2014,CA,216372,108187
22,28,2,163124,54400,2014,CA,217524,108763
23,29,3,79224,71036,2014,CA,150260,75131
24,30,4,0,211134,2014,CA,211134,105568
25,31,5,129613,0,2014,CA,129613,64807
26,32,6,97008,36448,2014,CA,133456,66729
27,33,7,92521,91066,2014,CA,183587,91794
28,34,8,37056,77480,2014,CA,114536,57269
29,35,9,63475,57729,2014,CA,121204,60603
30,36,10,55123,70582,2014,CA,125705,62853
31,37,11,117502,57160,2014,CA,174662,87332
32,38,12,160067,32197,2014,CA,192264,96133
33,39,13,168491,21940,2014,CA,190431,95216
34,40,14,114389,34757,2014,CA,149146,74574
35,41,15,99756,43150,2014,CA,142906,71454
36,42,16,46277,44943,2014,CA,91220,45611
37,43,17,134408,0,2014,CA,134408,67205
38,44,18,133060,63326,2014,CA,196386,98194
39,45,19,127788,0,2014,CA,127788,63895
40,46,20,106034,0,2014,CA,106034,53018
41,47,21,33470,45907,2014,CA,79377,39689
42,48,22,37289,96053,2014,CA,133342,66672
43,49,23,33726,100317,2014,CA,134043,67022
44,50,24,103228,95566,2014,CA,198794,99398
45,51,25,0,114072,2014,CA,114072,57037
46,52,26,87176,82653,2014,CA,169829,84915
47,53,27,75728,51852,2014,CA,127580,63791
48,54,28,91996,0,2014,CA,91996,45999
49,55,29,50096,17045,2014,CA,67141,33571
50,56,30,86568,45315,2014,CA,131883,65942
51,57,31,51622,48162,2014,CA,99784,49893
52,58,32,50353,34053,2014,CA,84406,42204
53,59,33,108331,74700,2014,CA,183031,91516
54,60,34,61621,0,2014,CA,61621,30811
55,61,35,62255,0,2014,CA,62255,31128
56,62,36,72682,61457,2014,CA,134139,67070
57,63,37,96787,18051,2014,CA,114838,57420
58,64,38,58192,40288,2014,CA,98480,49241
59,65,39,41906,91319,2014,CA,133225,66613
60,66,40,49379,0,2014,CA,49379,24690
61,67,41,46948,35936,2014,CA,82884,41443
62,68,42,38850,74540,2014,CA,113390,56696
63,69,43,69681,28521,2014,CA,98202,49102
64,70,44,59670,0,2014,CA,59670,29836
65,71,45,56819,106083,2014,CA,162902,81452
66,72,46,49738,33577,2014,CA,83315,41658
67,73,47,69091,54309,2014,CA,123400,61701
68,74,48,62713,112082,2014,CA,174795,87398
69,75,49,64981,98161,2014,CA,163142,81572
70,76,50,45302,111997,2014,CA,157299,78650
71,77,51,356378,25577,2014,CA,381955,190978
72,78,52,98826,92746,2014,CA,191572,95787
73,79,53,87104,60940,2014,CA,148044,74023
74,81,1,183281,80682,2014,CO,263963,131982
75,82,2,196300,149645,2014,CO,345945,172973
76,83,3,100364,163011,2014,CO,263375,131688
77,84,4,83727,185292,2014,CO,269019,134510
78,85,5,105673,157182,2014,CO,262855,131428
79,86,6,118847,143467,2014,CO,262314,131158
80,87,7,148225,120918,2014,CO,269143,134572
81,90,1,127430,78609,2014,CN,206039,103020
82,91,2,131294,80837,2014,CN,212131,106066
83,92,3,130009,69454,2014,CN,199463,99732
84,93,4,101401,88209,2014,CN,189610,94806
85,94,5,106256,92404,2014,CN,198660,99331
86,96,1,137251,85146,2014,DE,222397,111199
87,98,1,54976,165086,2014,FL,220062,110032
88,99,2,126096,123262,2014,FL,249358,124680
89,100,3,73910,148691,2014,FL,222601,111301
90,101,4,0,177887,2014,FL,177887,88944
91,102,5,112340,59237,2014,FL,171577,85789
92,103,6,99563,166254,2014,FL,265817,132909
93,104,7,73011,144474,2014,FL,217485,108743
94,105,8,93724,180728,2014,FL,274452,137227
95,106,9,93850,74963,2014,FL,168813,84407
96,107,10,89426,143128,2014,FL,232554,116278
97,108,11,90786,181508,2014,FL,272294,136148
98,109,12,0,1,2014,FL,1,1
99,110,13,0,168172,2014,FL,168172,84087
100,111,14,1,0,2014,FL,1,1
101,112,15,84832,128750,2014,FL,213582,106792
102,113,16,105483,169126,2014,FL,274609,137305
103,114,17,82263,141493,2014,FL,223756,111879
104,115,18,151478,101896,2014,FL,253374,126688
105,116,19,80824,159354,2014,FL,240178,120090
106,117,20,128498,28968,2014,FL,157466,78734
107,118,21,153395,0,2014,FL,153395,76698
108,119,22,125404,90685,2014,FL,216089,108045
109,120,23,103269,61519,2014,FL,164788,82395
110,121,24,129192,15239,2014,FL,144431,72216
111,122,25,0,1,2014,FL,1,1
112,123,26,78306,83031,2014,FL,161337,80669
113,124,27,0,1,2014,FL,1,1
114,126,1,61175,95337,2014,GA,156512,78257
115,127,2,96363,66537,2014,GA,162900,81451
116,128,3,0,156277,2014,GA,156277,78139
117,129,4,161211,0,2014,GA,161211,80606
118,130,5,170326,0,2014,GA,170326,85164
119,131,6,71486,139018,2014,GA,210504,105253
120,132,7,60112,113557,2014,GA,173669,86835
121,134,9,34988,146059,2014,GA,181047,90524
122,135,10,65777,130703,2014,GA,196480,98241
123,136,11,0,161532,2014,GA,161532,80767
124,137,12,75478,91336,2014,GA,166814,83408
125,138,13,159445,0,2014,GA,159445,79723
126,139,14,0,118782,2014,GA,118782,59392
127,142,1,93390,86454,2014,HI,179844,89923
128,143,2,142010,33630,2014,HI,175640,87821
129,146,1,77277,143580,2014,ID,220857,110429
130,147,2,82801,131492,2014,ID,214293,107147
131,150,1,162268,59749,2014,IL,222017,111009
132,151,2,160337,43799,2014,IL,204136,102069
133,152,3,116764,64091,2014,IL,180855,90428
134,153,4,79666,22278,2014,IL,101944,50973
135,154,5,116364,56350,2014,IL,172714,86358
136,155,6,78465,160287,2014,IL,238752,119377
137,156,7,155110,27168,2014,IL,182278,91140
138,157,8,84178,66878,2014,IL,151056,75529
139,158,9,41000,72384,2014,IL,113384,56693
140,159,10,91136,95992,2014,IL,187128,93565
141,160,11,93436,81335,2014,IL,174771,87386
142,161,12,87860,110038,2014,IL,197898,98950
143,162,13,86935,123337,2014,IL,210272,105137
144,163,14,76861,145369,2014,IL,222230,111116
145,164,15,55652,166274,2014,IL,221926,110964
146,165,16,63810,153388,2014,IL,217198,108600
147,166,17,110560,88785,2014,IL,199345,99673
148,167,18,62377,184363,2014,IL,246740,123371
149,170,1,86579,51000,2014,IN,137579,68790
150,171,2,55590,85583,2014,IN,141173,70587
151,172,3,39771,97892,2014,IN,137663,68832
152,173,4,47056,94998,2014,IN,142054,71028
153,174,5,49756,105277,2014,IN,155033,77517
154,175,6,45509,102187,2014,IN,147696,73849
155,176,7,61443,46887,2014,IN,108330,54166
156,177,8,61384,103344,2014,IN,164728,82365
157,178,9,55016,101594,2014,IN,156610,78306
158,180,1,141145,147762,2014,IA,288907,144454
159,181,2,143431,129455,2014,IA,272886,136444
160,182,3,119109,148814,2014,IA,267923,133962
161,183,4,105504,169834,2014,IA,275338,137670
162,186,1,65397,138764,2014,KS,204161,102081
163,187,2,87153,128742,2014,KS,215895,107948
164,188,3,89584,134493,2014,KS,224077,112039
165,189,4,69396,138757,2014,KS,208153,104077
166,192,1,63596,173022,2014,KY,236618,118310
167,193,2,69898,156936,2014,KY,226834,113418
168,194,3,157056,87981,2014,KY,245037,122519
169,195,4,71694,150464,2014,KY,222158,111080
170,196,5,47617,171350,2014,KY,218967,109484
171,197,6,98290,147404,2014,KY,245694,122848
172,200,1,46047,189250,2014,LA,235297,117649
173,201,2,190006,0,2014,LA,190006,95004
174,202,3,0,207926,2014,LA,207926,103964
175,203,4,0,152683,2014,LA,152683,76342
176,204,5,75006,247211,2014,LA,322217,161109
177,205,6,95127,234200,2014,LA,329327,164664
178,208,1,186674,94751,2014,ME,281425,140713
179,209,2,118568,133320,2014,ME,251888,125945
180,212,1,73843,176342,2014,MD,250185,125093
181,213,2,120412,70411,2014,MD,190823,95412
182,214,3,128594,87029,2014,MD,215623,107812
183,215,4,134628,54217,2014,MD,188845,94423
184,216,5,144725,80752,2014,MD,225477,112739
185,217,6,94704,91930,2014,MD,186634,93318
186,218,7,144639,55860,2014,MD,200499,100250
187,219,8,136722,87859,2014,MD,224581,112291
188,221,1,167612,0,2014,MA,167612,83807
189,222,2,169640,0,2014,MA,169640,84821
190,223,3,139104,81638,2014,MA,220742,110372
191,224,4,184158,0,2014,MA,184158,92080
192,225,5,182100,0,2014,MA,182100,91051
193,226,6,149638,111989,2014,MA,261627,130814
194,227,7,142133,0,2014,MA,142133,71067
195,228,8,200644,0,2014,MA,200644,100323
196,229,9,140413,114971,2014,MA,255384,127693
197,232,1,113263,130414,2014,MI,243677,121839
198,233,2,70851,135568,2014,MI,206419,103210
199,234,3,84720,125754,2014,MI,210474,105238
200,235,4,85777,123962,2014,MI,209739,104870
201,236,5,148182,69222,2014,MI,217404,108703
202,237,6,84391,116801,2014,MI,201192,100597
203,238,7,92083,119564,2014,MI,211647,105824
204,239,8,102269,132739,2014,MI,235008,117505
205,240,9,136342,81470,2014,MI,217812,108907
206,241,10,67143,157069,2014,MI,224212,112107
207,242,11,101681,140435,2014,MI,242116,121059
208,243,12,134346,64716,2014,MI,199062,99532
209,244,13,132710,27234,2014,MI,159944,79973
210,245,14,165272,41801,2014,MI,207073,103537
211,248,1,122851,103536,2014,MS,226387,113194
212,249,2,95565,137778,2014,MS,233343,116672
213,250,3,101846,167515,2014,MS,269361,134681
214,251,4,147857,79492,2014,MS,227349,113675
215,252,5,167079,56577,2014,MS,223656,111829
216,253,6,90926,133328,2014,MS,224254,112128
217,254,7,130546,109955,2014,MS,240501,120251
218,255,8,129090,125358,2014,MS,254448,127225
219,258,1,43713,102622,2014,MN,146335,73168
220,259,2,100688,0,2014,MN,100688,50345
221,260,3,47744,117771,2014,MN,165515,82758
222,261,4,37869,108776,2014,MN,146645,73323
223,264,1,119315,35273,2014,MO,154588,77295
224,265,2,75384,148191,2014,MO,223575,111788
225,266,3,52021,130940,2014,MO,182961,91481
226,267,4,46464,120014,2014,MO,166478,83240
227,268,5,79256,69071,2014,MO,148327,74164
228,269,6,55157,124616,2014,MO,179773,89887
229,270,7,47282,104054,2014,MO,151336,75669
230,271,8,38721,106124,2014,MO,144845,72423
231,272,,513600,838283,2014,MO,1351883,675942
232,273,1,148690,203871,2014,MT,352561,176281
233,275,1,55838,123219,2014,NE,179057,89529
234,276,2,83872,78157,2014,NE,162029,81015
235,277,3,45524,139440,2014,NE,184964,92483
236,280,1,45643,30413,2014,NV,76056,38029
237,281,2,52016,122402,2014,NV,174418,87210
238,282,3,52644,88528,2014,NV,141172,70587
239,283,4,59844,63466,2014,NV,123310,61656
240,285,1,116769,125508,2014,NH,242277,121139
241,286,2,130700,106871,2014,NH,237571,118786
242,289,1,93315,64073,2014,NJ,157388,78695
243,290,2,66026,108875,2014,NJ,174901,87451
244,291,3,82537,100471,2014,NJ,183008,91505
245,292,4,54415,118826,2014,NJ,173241,86621
246,293,5,81808,104678,2014,NJ,186486,93244
247,294,6,72190,46891,2014,NJ,119081,59541
248,295,7,68232,104287,2014,NJ,172519,86260
249,296,8,61510,15141,2014,NJ,76651,38326
250,297,9,82498,36246,2014,NJ,118744,59373
251,298,10,95734,14154,2014,NJ,109888,54945
252,299,11,65477,109455,2014,NJ,174932,87467
253,300,12,90430,54168,2014,NJ,144598,72300
254,303,1,105474,74558,2014,NM,180032,90017
255,304,2,52499,95209,2014,NM,147708,73855
256,305,3,113249,70775,2014,NM,184024,92013
257,308,1,68387,77062,2014,NY,145449,72725
258,309,2,41814,0,2014,NY,41814,20908
259,310,3,80393,63219,2014,NY,143612,71807
260,311,4,83772,0,2014,NY,83772,41887
261,312,5,75712,0,2014,NY,75712,37857
262,313,6,49227,0,2014,NY,49227,24614
263,314,7,47142,5713,2014,NY,52855,26428
264,315,8,70469,0,2014,NY,70469,35235
265,316,9,70997,0,2014,NY,70997,35499
266,317,10,73945,0,2014,NY,73945,36973
267,318,11,41429,48291,2014,NY,89720,44861
268,319,12,78440,19564,2014,NY,98004,49003
269,320,13,63437,0,2014,NY,63437,31719
270,321,14,45370,0,2014,NY,45370,22686
271,322,15,53128,0,2014,NY,53128,26565
272,323,16,90088,0,2014,NY,90088,45045
273,324,17,89295,63549,2014,NY,152844,76423
274,325,18,76235,66523,2014,NY,142758,71380
275,326,19,60533,102118,2014,NY,162651,81326
276,327,20,103437,61820,2014,NY,165257,82629
277,328,21,53140,79615,2014,NY,132755,66378
278,329,22,0,113574,2014,NY,113574,56788
279,330,23,60233,94375,2014,NY,154608,77305
280,331,24,72631,93881,2014,NY,166512,83257
281,332,25,87264,75990,2014,NY,163254,81628
282,333,26,100648,38477,2014,NY,139125,69563
283,334,27,50939,109171,2014,NY,160110,80056
284,336,1,154333,55990,2014,NC,210323,105162
285,337,2,85479,122128,2014,NC,207607,103804
286,338,3,66182,139415,2014,NC,205597,102799
287,339,4,169946,57416,2014,NC,227362,113682
288,340,5,88973,139279,2014,NC,228252,114127
289,341,6,103758,147312,2014,NC,251070,125536
290,342,7,84054,134431,2014,NC,218485,109243
291,343,8,65854,121568,2014,NC,187422,93712
292,344,9,0,163080,2014,NC,163080,81541
293,345,10,85292,133504,2014,NC,218796,109399
294,346,11,85342,144682,2014,NC,230024,115013
295,347,12,130096,42568,2014,NC,172664,86333
296,348,13,114718,153991,2014,NC,268709,134355
297,351,1,72604,124779,2014,ND,197383,98692
298,352,2,68453,132658,2014,OH,201111,100556
299,353,3,91769,51475,2014,OH,143244,71623
300,354,4,60165,125907,2014,OH,186072,93037
301,355,5,58507,134449,2014,OH,192956,96479
302,356,6,73561,111026,2014,OH,184587,92294
303,357,7,0,143959,2014,OH,143959,71980
304,358,8,51534,126539,2014,OH,178073,89037
305,359,9,108870,51704,2014,OH,160574,80288
306,360,10,63249,130752,2014,OH,194001,97001
307,361,11,137105,35461,2014,OH,172566,86284
308,362,12,61360,150573,2014,OH,211933,105967
309,363,13,120230,55233,2014,OH,175463,87732
310,364,14,70856,135736,2014,OH,206592,103297
311,365,15,66125,128496,2014,OH,194621,97311
312,366,16,75199,132176,2014,OH,207375,103688
313,368,1,0,-1,2014,OH,-1,0
314,369,2,38964,110925,2014,OK,149889,74945
315,370,3,36270,133335,2014,OK,169605,84803
316,371,4,40998,117721,2014,OK,158719,79360
317,372,5,57790,95632,2014,OK,153422,76712
318,375,1,160038,96245,2014,OK,256283,128142
319,376,2,73785,202374,2014,OK,276159,138080
320,377,3,211748,57424,2014,OK,269172,134587
321,378,4,181624,116534,2014,OR ,298158,149080
322,379,5,150944,110332,2014,OR ,261276,130639
323,382,1,131248,27193,2014,PA ,158441,79221
324,383,2,181141,25397,2014,PA ,206538,103270
325,384,3,73931,113859,2014,PA ,187790,93896
326,385,4,50250,147090,2014,PA,197340,98671
327,386,5,65839,115018,2014,PA,180857,90429
328,387,6,92901,119643,2014,PA,212544,106273
329,388,7,89256,145869,2014,PA,235125,117563
330,389,8,84767,137731,2014,PA,222498,111250
331,390,9,63223,110094,2014,PA,173317,86659
332,391,10,44737,112851,2014,PA,157588,78795
333,392,11,62228,122464,2014,PA,184692,92347
334,393,12,87928,127993,2014,PA,215921,107961
335,394,13,123601,60549,2014,PA,184150,92076
336,395,14,148351,0,2014,PA,148351,74176
337,396,15,0,128285,2014,PA,128285,64143
338,397,16,74513,101722,2014,PA,176235,88118
339,398,17,93680,71371,2014,PA,165051,82526
340,399,18,0,166076,2014,PA,166076,83039
341,400,18,0,166076,2014,PA,166076,83039
342,402,1,87060,58877,2014,RI,145937,72969
343,403,2,105716,63844,2014,RI,169560,84781
344,406,1,0,119392,2014,SC,119392,59697
345,407,2,68719,121649,2014,SC,190368,95185
346,408,3,47181,116741,2014,SC,163922,81962
347,409,4,0,126452,2014,SC,126452,63227
348,410,5,66802,103078,2014,SC,169880,84941
349,411,6,125747,44311,2014,SC,170058,85030
350,412,7,68576,102833,2014,SC,171409,85705
351,415,1,92485,183834,2014,SD,276319,138160
352,417,1,0,115533,2014,TN,115533,57767
353,418,2,37612,120883,2014,TN,158495,79248
354,419,3,53983,97344,2014,TN,151327,75664
355,420,4,51357,84815,2014,TN,136172,68087
356,421,5,96148,55078,2014,TN,151226,75614
357,422,6,37232,115231,2014,TN,152463,76232
358,423,7,42280,110534,2014,TN,152814,76408
359,424,8,42433,122255,2014,TN,164688,82345
360,425,9,87376,27173,2014,TN,114549,57275
361,428,1,33476,115084,2014,TX,148560,74281
362,429,2,44462,101936,2014,TX,146398,73200
363,430,3,0,113404,2014,TX,113404,56703
364,431,4,0,115085,2014,TX,115085,57543
365,432,5,0,88998,2014,TX,88998,44500
366,433,6,55027,92334,2014,TX,147361,73681
367,434,7,49478,90606,2014,TX,140084,70043
368,435,8,0,125066,2014,TX,125066,62534
369,436,9,78109,0,2014,TX,78109,39055
370,437,10,60243,109726,2014,TX,169969,84985
371,438,11,0,107939,2014,TX,107939,53970
372,439,12,41757,113186,2014,TX,154943,77472
373,440,13,16822,110842,2014,TX,127664,63833
374,441,14,52545,90116,2014,TX,142661,71331
375,442,15,48708,39016,2014,TX,87724,43863
376,443,16,49338,21324,2014,TX,70662,35332
377,444,17,43049,85807,2014,TX,128856,64429
378,445,18,76097,26249,2014,TX,102346,51174
379,446,19,21458,90160,2014,TX,111618,55810
380,447,20,66554,0,2014,TX,66554,33278
381,448,21,0,135660,2014,TX,135660,67831
382,449,22,47844,100861,2014,TX,148705,74353
383,450,23,55037,57459,2014,TX,112496,56249
384,451,24,46548,93712,2014,TX,140260,70131
385,452,25,64463,107120,2014,TX,171583,85792
386,453,26,0,116944,2014,TX,116944,58473
387,454,27,44152,83342,2014,TX,127494,63748
388,455,28,62508,0,2014,TX,62508,31255
389,456,29,41321,0,2014,TX,41321,20661
390,457,30,93041,0,2014,TX,93041,46521
391,458,31,45715,91607,2014,TX,137322,68662
392,459,32,55325,96495,2014,TX,151820,75911
393,460,33,43769,0,2014,TX,43769,21885
394,461,34,47503,30811,2014,TX,78314,39158
395,462,35,60124,32040,2014,TX,92164,46083
396,463,36,29543,101663,2014,TX,131206,65604
397,466,1,36422,84231,2014,UT,120653,60327
398,467,2,47585,88915,2014,UT,136500,68251
399,468,3,32059,102952,2014,UT,135011,67506
400,469,4,67425,74936,2014,UT,142361,71181
401,471,1,72059,131861,2014,VA,203920,101961
402,472,2,71178,101558,2014,VA,172736,86369
403,473,3,139197,0,2014,VA,139197,69599
404,474,4,75270,120684,2014,VA,195954,97978
405,475,5,73482,124735,2014,VA,198217,99109
406,476,6,0,133898,2014,VA,133898,66950
407,477,7,89914,148026,2014,VA,237940,118971
408,478,8,128102,63810,2014,VA,191912,95957
409,479,9,0,117465,2014,VA,117465,58733
410,480,10,89957,125914,2014,VA,215871,107936
411,481,11,106780,75796,2014,VA,182576,91289
412,484,1,123349,59432,2014,VT,182781,91391
413,485,1,124151,101428,2014,WA,225579,112790
414,486,2,122173,79518,2014,WA,201691,100846
415,487,3,78018,124796,2014,WA,202814,101408
416,488,4,0,153079,2014,WA,153079,76540
417,489,5,87772,135470,2014,WA,223242,111622
418,490,6,141265,83025,2014,WA,224290,112146
419,491,7,203954,47921,2014,WA,251875,125938
420,492,8,73003,125741,2014,WA,198744,99373
421,493,9,118132,48662,2014,WA,166794,83398
422,494,10,99279,82213,2014,WA,181492,90747
423,496,1,52109,92491,2014,WV,144600,72301
424,497,2,67687,72619,2014,WV,140306,70154
425,498,3,62688,77713,2014,WV,140401,70201
426,501,1,105552,182316,2014,WI,287868,143935
427,502,2,224920,103619,2014,WI,328539,164270
428,503,3,155368,119540,2014,WI,274908,137455
429,504,4,179045,68490,2014,WI,247535,123768
430,505,5,101190,231160,2014,WI,332350,166176
431,506,6,122212,169767,2014,WI,291979,145990
432,507,7,112949,169891,2014,WI,282840,141421
433,508,8,101345,188553,2014,WI,289898,144950
434,510,1,37803,113038,2014,WY,150841,75421
0,0,1,0,196374,2012,AL,196374,98188
1,1,2,103092,180591,2012,AL,283683,141842
2,2,3,98141,175306,2012,AL,273447,136724
3,3,4,69706,199071,2012,AL,268777,134389
4,4,5,101772,189185,2012,AL,290957,145479
5,5,6,88267,219262,2012,AL,307529,153765
6,6,7,232520,73835,2012,AL,306355,153178
7,9,1,82927,185296,2012,AK,268223,134112
8,11,1,122774,113594,2012,AZ,236368,118185
9,12,2,147338,144884,2012,AZ,292222,146112
10,13,3,98468,62663,2012,AZ,161131,80566
11,14,4,69154,162907,2012,AZ,232061,116031
12,15,5,89589,183470,2012,AZ,273059,136530
13,16,6,97666,179706,2012,AZ,277372,138687
14,17,7,104489,0,2012,AZ,104489,52245
15,18,8,95635,172809,2012,AZ,268444,134223
16,19,9,121881,111630,2012,AZ,233511,116756
17,23,1,96601,138800,2012,AR,235401,117701
18,24,2,113156,158175,2012,AR,271331,135666
19,25,3,0,186467,2012,AR,186467,93234
20,26,4,95013,154149,2012,AR,249162,124582
21,29,1,125386,168827,2012,CA,294213,147107
22,30,2,226216,91310,2012,CA,317526,158764
23,31,3,126882,107086,2012,CA,233968,116985
24,32,4,125885,197803,2012,CA,323688,161845
25,33,5,202872,69545,2012,CA,272417,136209
26,34,6,160667,53406,2012,CA,214073,107037
27,35,7,141241,132050,2012,CA,273291,136646
28,36,8,0,179644,2012,CA,179644,89823
29,37,9,118373,94704,2012,CA,213077,106539
30,38,10,98934,110265,2012,CA,209199,104600
31,39,11,200743,87136,2012,CA,287879,143940
32,40,12,253709,44478,2012,CA,298187,149094
33,41,13,250436,0,2012,CA,250436,125219
34,42,14,203828,54455,2012,CA,258283,129142
35,43,15,231034,0,2012,CA,231034,115518
36,44,16,84649,62801,2012,CA,147450,73726
37,45,17,159392,57336,2012,CA,216728,108365
38,46,18,212831,89103,2012,CA,301934,150968
39,47,19,162300,59313,2012,CA,221613,110807
40,48,20,172996,60566,2012,CA,233562,116782
41,49,21,49119,67164,2012,CA,116283,58142
42,50,22,81555,132386,2012,CA,213941,106971
43,51,23,0,158161,2012,CA,158161,79081
44,52,24,156749,127746,2012,CA,284495,142248
45,53,25,106982,129593,2012,CA,236575,118288
46,54,26,139072,124863,2012,CA,263935,131968
47,55,27,154191,86817,2012,CA,241008,120505
48,56,28,188703,58008,2012,CA,246711,123356
49,57,29,111287,0,2012,CA,111287,55644
50,58,30,247851,0,2012,CA,247851,123926
51,59,31,0,161219,2012,CA,161219,80610
52,60,32,124903,65208,2012,CA,190111,95056
53,61,33,171860,0,2012,CA,171860,85931
54,62,34,120367,20223,2012,CA,140590,70296
55,63,35,142680,0,2012,CA,142680,71341
56,64,36,110189,97953,2012,CA,208142,104072
57,65,37,207039,32541,2012,CA,239580,119791
58,66,38,145280,69807,2012,CA,215087,107544
59,67,39,106360,145607,2012,CA,251967,125984
60,68,40,125553,0,2012,CA,125553,62777
61,69,41,103578,72074,2012,CA,175652,87827
62,70,42,84702,130245,2012,CA,214947,107474
63,71,43,200894,0,2012,CA,200894,100448
64,72,44,165898,0,2012,CA,165898,82950
65,73,45,121814,171417,2012,CA,293231,146616
66,74,46,95694,54121,2012,CA,149815,74908
67,75,47,130093,99919,2012,CA,230012,115007
68,76,48,113358,177144,2012,CA,290502,145252
69,77,49,114893,159725,2012,CA,274618,137310
70,78,50,83455,174838,2012,CA,258293,129147
71,79,51,113934,45464,2012,CA,159398,79700
72,80,52,151451,144459,2012,CA,295910,147956
73,81,53,164825,103482,2012,CA,268307,134154
74,85,1,237579,93217,2012,CO,330796,165399
75,86,2,234758,162639,2012,CO,397397,198699
76,87,3,142619,185291,2012,CO,327910,163956
77,88,4,125800,200006,2012,CO,325806,162904
78,89,5,0,199639,2012,CO,199639,99820
79,90,6,156937,163938,2012,CO,320875,160438
80,91,7,182460,139066,2012,CO,321526,160764
81,94,1,192840,82321,2012,CT,275161,137581
82,95,2,189444,88103,2012,CT,277547,138774
83,96,3,197163,73726,2012,CT,270889,135445
84,97,4,167320,117503,2012,CT,284823,142412
85,98,5,137631,128927,2012,CT,266558,133280
86,102,1,249933,129757,2012,DE,379690,189846
87,105,1,92961,238440,2012,FL,331401,165701
88,106,2,157634,175856,2012,FL,333490,166746
89,107,3,102468,204331,2012,FL,306799,153400
90,108,4,0,239988,2012,FL,239988,119995
91,109,5,190472,70700,2012,FL,261172,130587
92,110,6,146489,195962,2012,FL,342451,171226
93,111,7,130479,185518,2012,FL,315997,157999
94,112,8,130870,205432,2012,FL,336302,168152
95,113,9,164891,98856,2012,FL,263747,131874
96,114,10,153574,164649,2012,FL,318223,159112
97,115,11,120303,218360,2012,FL,338663,169332
98,116,12,108770,209604,2012,FL,318374,159188
99,117,13,139742,189605,2012,FL,329347,164674
100,118,14,197121,83480,2012,FL,280601,140301
101,119,15,0,1,2012,FL,1,1
102,120,16,161929,187147,2012,FL,349076,174539
103,121,17,116766,165488,2012,FL,282254,141128
104,122,18,166257,164353,2012,FL,330610,165306
105,123,19,109746,189833,2012,FL,299579,149790
106,124,20,214727,0,2012,FL,214727,107364
107,125,21,221263,0,2012,FL,221263,110632
108,126,22,171021,142050,2012,FL,313071,156536
109,127,23,174205,98096,2012,FL,272301,136151
110,128,24,1,0,2012,FL,1,1
111,129,25,0,151466,2012,FL,151466,75734
112,130,26,135694,108820,2012,FL,244514,122258
113,131,27,85020,138488,2012,FL,223508,111755
114,135,1,92399,157181,2012,GA,249580,124791
115,136,2,162751,92410,2012,GA,255161,127581
116,137,3,0,232380,2012,GA,232380,116191
117,138,4,208861,75041,2012,GA,283902,141952
118,139,5,234330,43335,2012,GA,277665,138833
119,140,6,104365,189669,2012,GA,294034,147018
120,141,7,95377,156689,2012,GA,252066,126034
121,142,8,0,197789,2012,GA,197789,98895
122,143,9,60052,192101,2012,GA,252153,126077
123,144,10,0,211065,2012,GA,211065,105533
124,145,11,90353,196968,2012,GA,287321,143661
125,146,12,139148,119973,2012,GA,259121,129561
126,147,13,201988,79550,2012,GA,281538,140770
127,148,14,59245,159947,2012,GA,219192,109597
128,151,1,116505,96824,2012,HI,213329,106665
129,152,2,168503,40707,2012,HI,209210,104606
130,156,1,97450,199402,2012,ID,296852,148427
131,157,2,110847,207412,2012,ID,318259,159130
132,160,1,236854,83989,2012,IL,320843,160422
133,161,2,188303,69115,2012,IL,257418,128710
134,162,3,168738,77653,2012,IL,246391,123196
135,163,4,133226,27279,2012,IL,160505,80253
136,164,5,177729,77289,2012,IL,255018,127510
137,165,6,132991,193138,2012,IL,326129,163065
138,166,7,242439,31466,2012,IL,273905,136953
139,167,8,123206,101860,2012,IL,225066,112534
140,168,9,194869,98924,2012,IL,293793,146897
141,169,10,133890,130564,2012,IL,264454,132228
142,170,11,148928,105348,2012,IL,254276,127139
143,171,12,157000,129902,2012,IL,286902,143452
144,172,13,136032,137034,2012,IL,273066,136534
145,173,14,124351,177603,2012,IL,301954,150978
146,174,15,94162,205775,2012,IL,299937,149969
147,175,16,112301,181789,2012,IL,294090,147046
148,176,17,153519,134623,2012,IL,288142,144072
149,177,18,85164,244467,2012,IL,329631,164816
150,180,1,187743,91291,2012,IN,279034,139518
151,181,2,130113,134033,2012,IN,264146,132074
152,182,3,92363,187872,2012,IN,280235,140118
153,183,4,93015,168688,2012,IN,261703,130852
154,184,5,125347,194570,2012,IN,319917,159959
155,185,6,96678,162613,2012,IN,259291,129646
156,186,7,162122,95828,2012,IN,257950,128976
157,187,8,122325,151533,2012,IN,273858,136930
158,188,9,132848,165332,2012,IN,298180,149091
159,192,1,222422,162465,2012,IA,384887,192444
160,193,2,211863,161977,2012,IA,373840,186921
161,194,3,168632,202000,2012,IA,370632,185317
162,195,4,169470,200063,2012,IA,369533,184767
163,198,1,0,211337,2012,KS,211337,105669
164,199,2,113735,167463,2012,KS,281198,140600
165,200,3,0,201087,2012,KS,201087,100544
166,201,4,81770,161094,2012,KS,242864,121433
167,204,1,87199,199956,2012,KY,287155,143578
168,205,2,89541,181508,2012,KY,271049,135525
169,206,3,206385,111452,2012,KY,317837,158919
170,207,4,104734,186036,2012,KY,290770,145386
171,208,5,55447,195408,2012,KY,250855,125428
172,209,6,141438,153222,2012,KY,294660,147331
173,212,1,61703,218340,2012,LA,280043,140022
174,213,2,230417,50146,2012,LA,280563,140282
175,214,3,67070,240558,2012,LA,307628,153815
176,215,4,0,187894,2012,LA,187894,93948
177,216,5,0,202536,2012,LA,202536,101269
178,217,6,0,243553,2012,LA,243553,121777
179,220,1,236363,128440,2012,ME,364803,182402
180,221,2,191456,137542,2012,ME,328998,164500
181,225,1,92812,214204,2012,MD,307016,153509
182,226,2,194088,92071,2012,MD,286159,143080
183,227,3,213747,94549,2012,MD,308296,154149
184,228,4,240385,64560,2012,MD,304945,152473
185,229,5,238618,95271,2012,MD,333889,166945
186,230,6,181921,117313,2012,MD,299234,149618
187,231,7,247770,67405,2012,MD,315175,157588
188,232,8,217531,113033,2012,MD,330564,165283
189,236,1,261936,0,2012,MA,261936,130969
190,237,2,259257,0,2012,MA,259257,129629
191,238,3,212119,109372,2012,MA,321491,160746
192,239,4,221303,129936,2012,MA,351239,175620
193,240,5,257490,82944,2012,MA,340434,170218
194,241,6,180942,176612,2012,MA,357554,178778
195,242,7,210794,0,2012,MA,210794,105398
196,243,8,263999,82242,2012,MA,346241,173121
197,244,9,212754,116531,2012,MA,329285,164643
198,248,1,165179,167060,2012,MI,332239,166120
199,249,2,108973,194653,2012,MI,303626,151814
200,250,3,144108,171675,2012,MI,315783,157892
201,251,4,104996,197386,2012,MI,302382,151192
202,252,5,214531,103931,2012,MI,318462,159232
203,253,6,136563,174955,2012,MI,311518,155760
204,254,7,136849,169668,2012,MI,306517,153259
205,255,8,128657,202217,2012,MI,330874,165438
206,256,9,208846,114760,2012,MI,323606,161804
207,257,10,97734,226075,2012,MI,323809,161905
208,258,11,158879,181788,2012,MI,340667,170334
209,259,12,216884,92472,2012,MI,309356,154679
210,260,13,235336,38769,2012,MI,274105,137053
211,261,14,270450,51395,2012,MI,321845,160923
212,265,1,193211,142164,2012,MN,335375,167688
213,266,2,164338,193587,2012,MN,357925,178963
214,267,3,159937,222335,2012,MN,382272,191137
215,268,4,216685,109659,2012,MN,326344,163173
216,269,5,262102,88753,2012,MN,350855,175428
217,270,6,174944,179240,2012,MN,354184,177093
218,271,7,197791,114151,2012,MN,311942,155972
219,272,8,191976,160520,2012,MN,352496,176249
220,276,1,114076,186760,2012,MS,300836,150419
221,277,2,214978,99160,2012,MS,314138,157070
222,278,3,0,234717,2012,MS,234717,117359
223,279,4,82344,182998,2012,MS,265342,132672
224,283,1,267927,60832,2012,MO,328759,164380
225,284,2,146272,236971,2012,MO,383243,191622
226,285,3,111189,214843,2012,MO,326032,163017
227,286,4,113120,192237,2012,MO,305357,152679
228,287,5,200290,122149,2012,MO,322439,161220
229,288,6,108503,216906,2012,MO,325409,162705
230,289,7,98498,203565,2012,MO,302063,151032
231,290,8,73755,216083,2012,MO,289838,144920
232,294,1,204939,255468,2012,MT,460407,230204
233,297,1,81206,174889,2012,NE,256095,128048
234,298,2,129767,133964,2012,NE,263731,131866
235,299,3,65266,187423,2012,NE,252689,126345
236,303,1,113967,56521,2012,NV,170488,85245
237,304,2,102019,162213,2012,NV,264232,132117
238,305,3,116823,137244,2012,NV,254067,127034
239,306,4,120501,101261,2012,NV,221762,110882
240,310,1,171650,158659,2012,NH,330309,165155
241,311,2,169275,152977,2012,NH,322252,161127
242,314,1,210470,92459,2012,NJ,302929,151465
243,315,2,116462,166677,2012,NJ,283139,141570
244,316,3,145506,174253,2012,NJ,319759,159880
245,317,4,107991,195145,2012,NJ,303136,151569
246,318,5,130100,167501,2012,NJ,297601,148801
247,319,6,151782,84360,2012,NJ,236142,118072
248,320,7,123057,175662,2012,NJ,298719,149360
249,321,8,130853,31763,2012,NJ,162616,81309
250,322,9,162822,55091,2012,NJ,217913,108957
251,323,10,201435,24271,2012,NJ,225706,112854
252,324,11,123897,182237,2012,NJ,306134,153068
253,325,12,189926,80906,2012,NJ,270832,135417
254,329,1,162924,112473,2012,NM,275397,137699
255,330,2,92162,133180,2012,NM,225342,112672
256,331,3,167103,97616,2012,NM,264719,132360
257,335,1,0,106678,2012,NY,106678,53340
258,336,2,116083,0,2012,NY,116083,58042
259,337,3,98455,0,2012,NY,98455,49228
260,338,4,0,84982,2012,NY,84982,42492
261,339,5,0,17875,2012,NY,17875,8938
262,340,6,0,45992,2012,NY,45992,22997
263,341,7,0,0,2012,NY,0,1
264,342,8,0,15841,2012,NY,15841,7921
265,343,9,0,20899,2012,NY,20899,10450
266,344,10,0,35440,2012,NY,35440,17721
267,345,11,0,91030,2012,NY,91030,45516
268,346,12,0,41969,2012,NY,41969,20985
269,347,13,0,12132,2012,NY,12132,6067
270,348,14,0,19191,2012,NY,19191,9596
271,349,15,0,3487,2012,NY,3487,1744
272,350,16,0,53935,2012,NY,53935,26968
273,351,17,0,91899,2012,NY,91899,45950
274,352,18,0,113386,2012,NY,113386,56694
275,353,19,0,122654,2012,NY,122654,61328
276,354,20,0,79102,2012,NY,79102,39552
277,355,21,0,104368,2012,NY,104368,52185
278,356,22,0,145042,2012,NY,145042,72522
279,357,23,0,117641,2012,NY,117641,58821
280,358,24,0,105584,2012,NY,105584,52793
281,359,25,0,109292,2012,NY,109292,54647
282,360,26,0,57368,2012,NY,57368,28685
283,361,27,0,137250,2012,NY,137250,68626
284,365,1,254644,77288,2012,NC,331932,165967
285,366,2,128973,174066,2012,NC,303039,151520
286,367,3,114314,195571,2012,NC,309885,154943
287,368,4,259534,88951,2012,NC,348485,174243
288,369,5,148252,200945,2012,NC,349197,174599
289,370,6,142467,222116,2012,NC,364583,182292
290,371,7,168695,168041,2012,NC,336736,168369
291,372,8,137139,160695,2012,NC,297834,148918
292,373,9,171503,194537,2012,NC,366040,183021
293,374,10,144023,190826,2012,NC,334849,167425
294,375,11,141107,190319,2012,NC,331426,165714
295,376,12,247591,63317,2012,NC,310908,155455
296,377,13,160115,210495,2012,NC,370610,185306
297,380,1,131870,173585,2012,ND,305455,152728
298,383,1,131490,201907,2012,OH,333397,166699
299,384,2,137077,194296,2012,OH,331373,165687
300,385,3,201897,77901,2012,OH,279798,139900
301,386,4,114214,182643,2012,OH,296857,148429
302,387,5,137806,201514,2012,OH,339320,169661
303,388,6,144444,164536,2012,OH,308980,154491
304,389,7,137708,178104,2012,OH,315812,157907
305,390,8,0,246378,2012,OH,246378,123190
306,391,9,217771,68668,2012,OH,286439,143220
307,392,10,131097,208201,2012,OH,339298,169650
308,393,11,258359,0,2012,OH,258359,129180
309,394,12,134605,233869,2012,OH,368474,184238
310,395,13,235492,88120,2012,OH,323612,161807
311,396,14,131637,183657,2012,OH,315294,157648
312,397,15,128188,205274,2012,OH,333462,166732
313,398,16,170600,185165,2012,OH,355765,177883
314,402,1,91421,181084,2012,OK,272505,136253
315,403,2,96081,143701,2012,OK,239782,119892
316,404,3,53472,201744,2012,OK,255216,127609
317,405,4,71846,176740,2012,OK,248586,124294
318,406,5,97504,153603,2012,OK,251107,125554
319,409,1,197845,109699,2012,OR,307544,153773
320,410,2,0,228043,2012,OR,228043,114022
321,411,3,264979,70325,2012,OR,335304,167653
322,412,4,212866,0,2012,OR,212866,106434
323,413,5,177229,139223,2012,OR,316452,158227
324,416,1,235394,41708,2012,PA,277102,138552
325,417,2,318176,33381,2012,PA,351557,175779
326,418,3,123933,165826,2012,PA,289759,144880
327,419,4,104643,181603,2012,PA,286246,143124
328,420,5,104725,177740,2012,PA,282465,141233
329,421,6,143803,191725,2012,PA,335528,167765
330,422,7,143509,209942,2012,PA,353451,176726
331,423,8,152859,199379,2012,PA,352238,176120
332,424,9,105128,169177,2012,PA,274305,137153
333,425,10,94227,179563,2012,PA,273790,136896
334,426,11,118231,166967,2012,PA,285198,142600
335,427,12,163589,175352,2012,PA,338941,169471
336,428,13,209901,93918,2012,PA,303819,151910
337,429,14,251932,75702,2012,PA,327634,163818
338,430,15,128764,168960,2012,PA,297724,148863
339,431,16,111185,156192,2012,PA,267377,133689
340,432,17,161393,106208,2012,PA,267601,133801
341,433,18,122146,216727,2012,PA,338873,169437
342,437,1,108612,83737,2012,RI,192349,96175
343,438,2,124067,78189,2012,RI,202256,101129
344,442,1,98154,179908,2012,SC,278062,139032
345,443,2,0,196116,2012,SC,196116,98059
346,444,3,84735,169512,2012,SC,254247,127124
347,445,4,84087,173201,2012,SC,257288,128645
348,446,5,113904,154324,2012,SC,268228,134115
349,447,6,218717,0,2012,SC,218717,109359
350,448,7,114594,153068,2012,SC,267662,133832
351,451,1,153789,207640,2012,SD,361429,180715
352,453,1,47663,182252,2012,TN,229915,114958
353,454,2,54522,196894,2012,TN,251416,125709
354,455,3,91094,157830,2012,TN,248924,124463
355,456,4,102022,128568,2012,TN,230590,115296
356,457,5,171621,86240,2012,TN,257861,128931
357,458,6,0,184383,2012,TN,184383,92192
358,459,7,61679,182730,2012,TN,244409,122205
359,460,8,79490,190923,2012,TN,270413,135207
360,461,9,188422,59742,2012,TN,248164,124083
361,465,1,67222,178322,2012,TX,245544,122773
362,466,2,80512,159664,2012,TX,240176,120089
363,467,3,0,187180,2012,TX,187180,93591
364,468,4,60214,182679,2012,TX,242893,121447
365,469,5,69178,134091,2012,TX,203269,101635
366,470,6,98053,145019,2012,TX,243072,121537
367,471,7,85553,142793,2012,TX,228346,114174
368,472,8,51051,194043,2012,TX,245094,122548
369,473,9,144075,36139,2012,TX,180214,90108
370,474,10,95710,159783,2012,TX,255493,127747
371,475,11,41970,177742,2012,TX,219712,109857
372,476,12,66080,175649,2012,TX,241729,120865
373,477,13,0,187775,2012,TX,187775,93888
374,478,14,109697,131460,2012,TX,241157,120579
375,479,15,89296,54056,2012,TX,143352,71677
376,480,16,101403,51043,2012,TX,152446,76224
377,481,17,0,143284,2012,TX,143284,71643
378,482,18,146223,44015,2012,TX,190238,95120
379,483,19,0,163239,2012,TX,163239,81620
380,484,20,119032,62376,2012,TX,181408,90705
381,485,21,109326,187015,2012,TX,296341,148171
382,486,22,80203,160668,2012,TX,240871,120436
383,487,23,96676,87547,2012,TX,184223,92112
384,488,24,87645,148586,2012,TX,236231,118116
385,489,25,98827,154245,2012,TX,253072,126537
386,490,26,74237,176642,2012,TX,250879,125440
387,491,27,83395,120684,2012,TX,204079,102040
388,492,28,112456,49309,2012,TX,161765,80883
389,493,29,86053,0,2012,TX,86053,43027
390,494,30,171059,41222,2012,TX,212281,106141
391,495,31,82977,145348,2012,TX,228325,114163
392,496,32,99288,146653,2012,TX,245941,122971
393,497,33,85114,30252,2012,TX,115366,57684
394,498,34,89606,52448,2012,TX,142054,71028
395,499,35,105626,52894,2012,TX,158520,79261
396,500,36,62143,165405,2012,TX,227548,113775
397,504,1,60611,175487,2012,UT,236098,118050
398,505,2,83176,154523,2012,UT,237699,118850
399,506,3,60719,198828,2012,UT,259547,129774
400,507,4,119803,119035,2012,UT,238838,119420
401,511,1,208600,67543,2012,VT,276143,138072
402,514,1,147036,200845,2012,VA,347881,173941
403,515,2,142548,166231,2012,VA,308779,154390
404,516,3,259199,58931,2012,VA,318130,159066
405,517,4,150190,199292,2012,VA,349482,174742
406,518,5,149214,193009,2012,VA,342223,171112
407,519,6,111949,211278,2012,VA,323227,161614
408,520,7,158012,222983,2012,VA,380995,190498
409,521,8,226847,107370,2012,VA,334217,167109
410,522,9,116400,184882,2012,VA,301282,150642
411,523,10,142024,214038,2012,VA,356062,178032
412,524,11,202606,117902,2012,VA,320508,160255
413,528,1,177025,151187,2012,WA,328212,164107
414,529,2,184826,117465,2012,WA,302291,151146
415,530,3,116438,177446,2012,WA,293884,146943
416,531,4,78940,154749,2012,WA,233689,116845
417,532,5,117512,191066,2012,WA,308578,154290
418,533,6,186661,129725,2012,WA,316386,158194
419,534,7,298368,76212,2012,WA,374580,187291
420,535,8,121886,180204,2012,WA,302090,151046
421,536,9,192034,76105,2012,WA,268139,134070
422,537,10,163036,115381,2012,WA,278417,139209
423,541,1,80342,133809,2012,WV,214151,107076
424,542,2,68560,158206,2012,WV,226766,113384
425,543,3,108199,92238,2012,WV,200437,100219
426,547,1,158414,200423,2012,WI,358837,179419
427,548,2,265422,124683,2012,WI,390105,195053
428,549,3,217712,121713,2012,WI,339425,169713
429,550,4,235257,80787,2012,WI,316044,158023
430,551,5,118478,250335,2012,WI,368813,184407
431,552,6,135921,223460,2012,WI,359381,179691
432,553,7,157524,201720,2012,WI,359244,179623
433,554,8,156287,198874,2012,WI,355161,177581
434,558,1,57573,166452,2012,WY,224025,112013
0,0,1,95503,121655,2010,NH,217158,108580
1,1,2,105060,108610,2010,NH,213670,106836
2,0,1,99387,65558,2010,IN,164945,82473
3,1,2,91341,88803,2010,IN,180144,90073
4,2,3,61267,116140,2010,IN,177407,88704
5,3,4,53167,138732,2010,IN,191899,95950
6,4,5,60024,146899,2010,IN,206923,103462
7,5,6,56647,126027,2010,IN,182674,91338
8,6,7,86647,55213,2010,IN,141860,70931
9,7,8,76265,117259,2010,IN,193524,96763
10,8,9,95353,118040,2010,IN,213393,106697
11,0,1,44068,142281,2010,KS,186349,93175
12,1,2,66588,130034,2010,KS,196622,98312
13,2,3,90193,136246,2010,KS,226439,113220
14,3,4,74143,119575,2010,KS,193718,96860
15,0,1,173543,125442,2010,DE,298985,149493
16,0,1,103294,70867,2010,NC,174161,87081
17,1,2,92393,93876,2010,NC,186269,93135
18,2,3,51317,143225,2010,NC,194542,97272
19,3,4,155384,116448,2010,NC,271832,135917
20,4,5,72762,140525,2010,NC,213287,106644
21,5,6,51507,156252,2010,NC,207759,103880
22,6,7,113957,98328,2010,NC,212285,106143
23,7,8,88776,73129,2010,NC,161905,80953
24,8,9,71450,158790,2010,NC,230240,115121
25,9,10,52972,130813,2010,NC,183785,91893
26,10,11,131225,110246,2010,NC,241471,120736
27,11,12,103495,55315,2010,NC,158810,79406
28,12,13,116103,93099,2010,NC,209202,104602
29,0,1,46449,117270,2010,GA,163719,81860
30,1,2,86520,81673,2010,GA,168193,84097
31,2,3,73932,168304,2010,GA,242236,121119
32,3,4,131760,44707,2010,GA,176467,88234
33,4,5,130782,46622,2010,GA,177404,88703
34,5,6,0,198100,2010,GA,198100,99051
35,6,7,78996,160898,2010,GA,239894,119948
36,7,8,92250,102770,2010,GA,195020,97511
37,8,9,0,173512,2010,GA,173512,86757
38,9,10,66905,138062,2010,GA,204967,102484
39,10,11,0,1635151,2010,GA,1635151,817576
40,11,12,92459,70938,2010,GA,163397,81699
41,12,13,140294,61771,2010,GA,202065,101033
42,0,1,62090,153840,2010,KY,215930,107966
43,1,2,73749,155906,2010,KY,229655,114828
44,2,3,139940,112627,2010,KY,252567,126284
45,3,4,66694,151813,2010,KY,218507,109254
46,4,5,44034,151019,2010,KY,195053,97527
47,5,6,119812,119164,2010,KY,238976,119489
48,0,1,102135,126231,2010,ID,228366,114184
49,1,2,48749,137468,2010,ID,186217,93109
50,0,1,89388,121074,2010,MS,210462,105232
51,1,2,105327,64499,2010,MS,169826,84914
52,2,3,60737,132393,2010,MS,193130,96566
53,3,4,95243,105613,2010,MS,200856,100429
54,0,1,0,170821,2010,FL,170821,85411
55,1,2,105211,136371,2010,FL,241582,120792
56,2,3,94744,50932,2010,FL,145676,72839
57,3,4,0,178238,2010,FL,178238,89120
58,4,5,100858,208815,2010,FL,309673,154837
59,5,6,0,179349,2010,FL,179349,89675
60,6,7,83206,185470,2010,FL,268676,134339
61,7,8,84167,123586,2010,FL,207753,103877
62,8,9,66158,165433,2010,FL,231591,115796
63,9,10,71313,137943,2010,FL,209256,104629
64,10,11,91328,61817,2010,FL,153145,76573
65,11,12,87769,102704,2010,FL,190473,95237
66,12,13,83123,183811,2010,FL,266934,133468
67,13,14,74525,188341,2010,FL,262866,131434
68,14,15,85595,157079,2010,FL,242674,121338
69,15,16,80327,162285,2010,FL,242612,121307
70,16,17,106361,0,2010,FL,106361,53181
71,17,18,46235,102360,2010,FL,148595,74298
72,18,19,132098,78733,2010,FL,210831,105416
73,19,20,100787,63845,2010,FL,164632,82317
74,20,21,0,1,2010,FL,1,1
75,21,22,99804,118890,2010,FL,218694,109348
76,22,23,100066,26414,2010,FL,126480,63241
77,23,24,98787,146129,2010,FL,244916,122459
78,24,25,61138,74859,2010,FL,135997,67999
79,0,1,38416,157182,2010,LA,195598,97800
80,1,2,83705,43378,2010,LA,127083,63542
81,2,3,61914,108963,2010,LA,170877,85439
82,3,4,54609,105223,2010,LA,159832,79917
83,4,5,0,122033,2010,LA,122033,61017
84,5,6,72577,138607,2010,LA,211184,105593
85,6,7,0,1,2010,LA,1,1
86,0,1,94140,82723,2010,HI,176863,88432
87,1,2,132290,46404,2010,HI,178694,89348
88,0,1,77606,175384,2010,AK,252990,126496
89,0,1,103246,58995,2010,NV,162241,81121
90,1,2,87421,169458,2010,NV,256879,128440
91,2,3,127168,128916,2010,NV,256084,128043
92,0,1,92672,103770,2010,OH,196442,98222
93,1,2,82431,139027,2010,OH,221458,110730
94,2,3,71455,152629,2010,OH,224084,112043
95,3,4,50533,146029,2010,OH,196562,98282
96,4,5,54919,140703,2010,OH,195622,97812
97,5,6,92823,103170,2010,OH,195993,97997
98,6,7,70400,135721,2010,OH,206121,103061
99,7,8,65883,142731,2010,OH,208614,104308
100,8,9,121819,83423,2010,OH,205242,102622
101,9,10,101343,83809,2010,OH,185152,92577
102,10,11,139693,28754,2010,OH,168447,84224
103,11,12,110307,150163,2010,OH,260470,130236
104,12,13,118806,94367,2010,OH,213173,106587
105,13,14,72604,149878,2010,OH,222482,111242
106,14,15,91077,119471,2010,OH,210548,105275
107,15,16,90833,114652,2010,OH,205485,102743
108,16,17,102758,57352,2010,OH,160110,80056
109,17,18,80756,107426,2010,OH,188182,94092
110,0,1,121954,217696,2010,MT,339650,169826
111,7,1,0,129063,2010,AL,129063,64532
112,8,2,106865,111645,2010,AL,218510,109256
113,9,3,80204,117736,2010,AL,197940,98971
114,10,4,0,167714,2010,AL,167714,83858
115,11,5,95192,131109,2010,AL,226301,113151
116,12,6,0,205288,2010,AL,205288,102645
117,13,7,136696,51890,2010,AL,188586,94294
118,0,1,46765,135247,2010,UT,182012,91007
119,1,2,127151,116001,2010,UT,243152,121577
120,2,3,44320,139721,2010,UT,184041,92021
121,10,1,79363,179819,2010,WI,259182,129592
122,11,2,191164,118099,2010,WI,309263,154632
123,12,3,126380,116838,2010,WI,243218,121610
124,13,4,143559,61543,2010,WI,205102,102552
125,14,5,90634,229642,2010,WI,320276,160139
126,15,6,75926,183271,2010,WI,259197,129599
127,16,7,113018,132551,2010,WI,245569,122785
128,17,8,118646,143998,2010,WI,262644,131323
129,0,1,89220,90660,2010,WV,179880,89941
130,1,2,55001,126814,2010,WV,181815,90908
131,2,3,83636,65611,2010,WV,149247,74624
132,0,1,0,129398,2010,TX,129398,64700
133,1,2,0,130020,2010,TX,130020,65011
134,2,3,47848,101180,2010,TX,149028,74515
135,3,4,40975,136338,2010,TX,177313,88657
136,4,5,41649,106742,2010,TX,148391,74196
137,5,6,50717,107140,2010,TX,157857,78929
138,6,7,0,143655,2010,TX,143655,71828
139,7,8,34694,161417,2010,TX,196111,98056
140,8,9,80107,24201,2010,TX,104308,52155
141,9,10,74086,144980,2010,TX,219066,109534
142,10,11,23989,125581,2010,TX,149570,74786
143,11,12,38434,109882,2010,TX,148316,74159
144,12,13,0,113201,2010,TX,113201,56601
145,13,14,44431,140623,2010,TX,185054,92528
146,14,15,53546,39964,2010,TX,93510,46756
147,15,16,49301,31051,2010,TX,80352,40177
148,16,17,63138,106696,2010,TX,169834,84918
149,17,18,85108,33067,2010,TX,118175,59088
150,18,19,25984,106059,2010,TX,132043,66022
151,19,20,58645,31757,2010,TX,90402,45202
152,20,21,65927,162924,2010,TX,228851,114426
153,21,22,62082,140537,2010,TX,202619,101310
154,22,23,67348,74853,2010,TX,142201,71101
155,23,24,0,100078,2010,TX,100078,50040
156,24,25,99967,84849,2010,TX,184816,92409
157,25,26,55385,120984,2010,TX,176369,88185
158,26,27,50179,50976,2010,TX,101155,50578
159,27,28,62773,46740,2010,TX,109513,54757
160,28,29,43257,22825,2010,TX,66082,33042
161,29,30,86322,24668,2010,TX,110990,55496
162,30,31,0,126384,2010,TX,126384,63193
163,31,32,44258,79433,2010,TX,123691,61846
164,0,1,128011,74418,2010,MA,202429,101215
165,1,2,122751,91209,2010,MA,213960,106981
166,2,3,122708,85124,2010,MA,207832,103917
167,3,4,126194,101517,2010,MA,227711,113856
168,4,5,122858,94646,2010,MA,217504,108753
169,5,6,142732,107930,2010,MA,250662,125332
170,6,7,145696,73467,2010,MA,219163,109582
171,7,8,134974,0,2010,MA,134974,67488
172,8,9,157071,59965,2010,MA,217036,108519
173,9,10,132743,120029,2010,MA,252772,126387
174,0,1,47106,116871,2010,NE,163977,81989
175,1,2,60486,93840,2010,NE,154326,77164
176,2,3,29932,117275,2010,NE,147207,73604
177,0,1,106542,129802,2010,ND,236344,118173
178,0,1,78267,93224,2010,AR,171491,85746
179,1,2,80687,122091,2010,AR,202778,101390
180,2,3,56542,148581,2010,AR,205123,102562
181,3,4,102479,71526,2010,AR,174005,87003
182,0,1,140073,59747,2010,CO,199820,99911
183,1,2,148720,98171,2010,CO,246891,123446
184,2,3,118048,129257,2010,CO,247305,123653
185,3,4,109249,138634,2010,CO,247883,123942
186,4,5,68039,152829,2010,CO,220868,110435
187,5,6,104104,217368,2010,CO,321472,160737
188,6,7,112667,88026,2010,CO,200693,100347
189,0,1,146589,153703,2010,SD,300292,150147
190,0,1,149944,0,2010,PA,149944,74973
191,1,2,182800,21907,2010,PA,204707,102354
192,2,3,88924,111909,2010,PA,200833,100417
193,3,4,120827,116958,2010,PA,237785,118893
194,4,5,52375,127427,2010,PA,179802,89902
195,5,6,100493,133770,2010,PA,234263,117132
196,6,7,110314,137825,2010,PA,248139,124070
197,7,8,113547,130759,2010,PA,244306,122154
198,8,9,52322,141904,2010,PA,194226,97114
199,9,10,89846,110599,2010,PA,200445,100223
200,10,11,84618,102179,2010,PA,186797,93399
201,11,12,94056,91170,2010,PA,185226,92614
202,12,13,118710,91987,2010,PA,210697,105349
203,13,14,122073,49997,2010,PA,172070,86036
204,14,15,79766,109534,2010,PA,189300,94651
205,15,16,70994,134113,2010,PA,205107,102554
206,16,17,118486,95000,2010,PA,213486,106744
207,17,18,78558,161888,2010,PA,240446,120224
208,18,19,53549,165219,2010,PA,218768,109385
209,0,1,154006,76403,2010,VT,230409,115205
210,0,1,130538,84076,2010,CT,214614,107308
211,1,2,140888,95671,2010,CT,236559,118280
212,2,3,134544,74107,2010,CT,208651,104326
213,3,4,110746,102030,2010,CT,212776,106389
214,4,5,118231,102092,2010,CT,220323,110162
215,0,1,45768,131661,2010,WY,177429,88715
216,4,1,160357,122858,2010,OR,283215,141608
217,5,2,72173,206245,2010,OR,278418,139210
218,6,3,193104,67714,2010,OR,260818,130410
219,7,4,162416,129877,2010,OR,292293,146147
220,8,5,145319,130313,2010,OR,275632,137817
221,0,1,135907,43649,2010,MO,179556,89779
222,1,2,77467,180481,2010,MO,257948,128975
223,2,3,99398,94757,2010,MO,194155,97078
224,3,4,101532,113489,2010,MO,215021,107511
225,4,5,102076,84578,2010,MO,186654,93328
226,5,6,67762,154103,2010,MO,221865,110933
227,6,7,67545,141010,2010,MO,208555,104278
228,7,8,56377,128499,2010,MO,184876,92439
229,8,9,0,162724,2010,MO,162724,81363
230,0,1,122365,109242,2010,MN,231607,115804
231,1,2,104809,181341,2010,MN,286150,143076
232,2,3,100240,161177,2010,MN,261417,130709
233,3,4,136746,80141,2010,MN,216887,108444
234,4,5,154833,55222,2010,MN,210055,105028
235,5,6,120846,159476,2010,MN,280322,140162
236,6,7,133096,90652,2010,MN,223748,111875
237,7,8,129091,133490,2010,MN,262581,131291
238,2,1,147307,72803,2010,CA,220110,110056
239,3,2,98092,130837,2010,CA,228929,114465
240,4,3,113128,131169,2010,CA,244297,122149
241,5,4,95653,186397,2010,CA,282050,141026
242,6,5,124220,43577,2010,CA,167797,83899
243,7,6,172216,77361,2010,CA,249577,124789
244,8,7,122435,56764,2010,CA,179199,89600
245,9,8,167957,31711,2010,CA,199668,99835
246,10,9,180400,23054,2010,CA,203454,101728
247,11,10,137578,88512,2010,CA,226090,113046
248,12,11,115361,112703,2010,CA,228064,114033
249,13,12,152044,44475,2010,CA,196519,98260
250,14,13,118278,45575,2010,CA,163853,81927
251,15,14,151217,60917,2010,CA,212134,106068
252,16,15,126147,60468,2010,CA,186615,93308
253,17,16,105841,37913,2010,CA,143754,71878
254,18,17,118734,53176,2010,CA,171910,85956
255,19,18,72853,51716,2010,CA,124569,62285
256,20,19,69912,128394,2010,CA,198306,99154
257,21,20,46247,43197,2010,CA,89444,44723
258,22,21,0,135979,2010,CA,135979,67990
259,23,22,0,173490,2010,CA,173490,86746
260,24,23,111768,72744,2010,CA,184512,92257
261,25,24,96279,144055,2010,CA,240334,120168
262,26,25,73028,118308,2010,CA,191336,95669
263,27,26,76093,112774,2010,CA,188867,94434
264,28,27,102927,55056,2010,CA,157983,78992
265,29,28,88385,28493,2010,CA,116878,58440
266,30,29,104374,51534,2010,CA,155908,77955
267,31,30,153663,75948,2010,CA,229611,114806
268,32,31,76363,14740,2010,CA,91103,45552
269,33,32,77759,31697,2010,CA,109456,54729
270,34,33,131990,21342,2010,CA,153332,76667
271,35,34,69382,20457,2010,CA,89839,44920
272,36,35,98131,25561,2010,CA,123692,61847
273,37,36,114489,66706,2010,CA,181195,90598
274,38,37,85799,29159,2010,CA,114958,57480
275,39,38,85459,30883,2010,CA,116342,58172
276,40,39,81590,42037,2010,CA,123627,61814
277,41,40,59400,119455,2010,CA,178855,89428
278,42,41,74394,127857,2010,CA,202251,101126
279,43,42,65122,127161,2010,CA,192283,96142
280,44,43,70026,36890,2010,CA,106916,53459
281,45,44,85784,107482,2010,CA,193266,96634
282,46,45,87141,106472,2010,CA,193613,96807
283,47,46,84940,139822,2010,CA,224762,112382
284,48,47,50832,37679,2010,CA,88511,44256
285,49,48,88465,145481,2010,CA,233946,116974
286,50,49,59714,119088,2010,CA,178802,89402
287,51,50,97818,142247,2010,CA,240065,120033
288,52,51,86423,57488,2010,CA,143911,71956
289,53,52,70870,139460,2010,CA,210330,105166
290,54,53,104800,57230,2010,CA,162030,81016
291,11,1,106334,58562,2010,NJ,164896,82449
292,12,2,51690,109460,2010,NJ,161150,80576
293,13,3,104252,110215,2010,NJ,214467,107234
294,14,4,52118,129752,2010,NJ,181870,90936
295,15,5,62634,124030,2010,NJ,186664,93333
296,16,6,81933,65413,2010,NJ,147346,73674
297,17,7,71902,105084,2010,NJ,176986,88494
298,18,8,88478,51023,2010,NJ,139501,69751
299,19,9,83564,52082,2010,NJ,135646,67824
300,20,10,95299,14357,2010,NJ,109656,54829
301,21,11,55472,122149,2010,NJ,177621,88811
302,22,12,108214,93634,2010,NJ,201848,100925
303,23,13,62840,19538,2010,NJ,82378,41190
304,0,1,73824,135564,2010,VA,209388,104695
305,1,2,70591,88340,2010,VA,158931,79466
306,2,3,114754,44553,2010,VA,159307,79654
307,3,4,74298,123659,2010,VA,197957,98979
308,4,5,110562,119560,2010,VA,230122,115062
309,5,6,0,127487,2010,VA,127487,63744
310,6,7,79616,138209,2010,VA,217825,108913
311,7,8,116404,71145,2010,VA,187549,93775
312,8,9,86743,95726,2010,VA,182469,91235
313,9,10,72604,131116,2010,VA,203720,101861
314,10,11,111720,110739,2010,VA,222459,111230
315,0,1,148170,29253,2010,IL,177423,88712
316,1,2,150666,25883,2010,IL,176549,88275
317,2,3,116120,40479,2010,IL,156599,78300
318,3,4,63273,11711,2010,IL,74984,37493
319,4,5,108360,38935,2010,IL,147295,73648
320,5,6,65379,114456,2010,IL,179835,89918
321,6,7,149846,29575,2010,IL,179421,89711
322,7,8,97825,98115,2010,IL,195940,97971
323,8,9,117553,55182,2010,IL,172735,86368
324,9,10,105290,109941,2010,IL,215231,107616
325,10,11,96019,129108,2010,IL,225127,112564
326,11,12,121272,74046,2010,IL,195318,97660
327,12,13,86281,152132,2010,IL,238413,119207
328,13,14,98645,112369,2010,IL,211014,105508
329,14,15,75948,136915,2010,IL,212863,106432
330,15,16,66037,138299,2010,IL,204336,102169
331,16,17,85454,104583,2010,IL,190037,95019
332,17,18,57046,152868,2010,IL,209914,104958
333,18,19,67132,166166,2010,IL,233298,116650
334,0,1,169114,128501,2010,ME,297615,148808
335,1,2,147042,119669,2010,ME,266711,133356
336,0,1,81269,71542,2010,RI,152811,76406
337,1,2,104442,55409,2010,RI,159851,79926
338,0,1,120400,155118,2010,MD,275518,137760
339,1,2,134133,69523,2010,MD,203656,101829
340,2,3,147448,86947,2010,MD,234395,117198
341,3,4,160228,31467,2010,MD,191695,95848
342,4,5,155110,83575,2010,MD,238685,119343
343,5,6,80455,148820,2010,MD,229275,114638
344,6,7,152669,46375,2010,MD,199044,99523
345,7,8,153613,52421,2010,MD,206034,103018
346,0,1,94824,120523,2010,MI,215347,107674
347,1,2,72118,138864,2010,MI,210982,105492
348,2,3,83953,133714,2010,MI,217667,108834
349,3,4,68458,148531,2010,MI,216989,108495
350,4,5,107285,89680,2010,MI,196965,98483
351,5,6,66729,123142,2010,MI,189871,94936
352,6,7,102402,113185,2010,MI,215587,107794
353,7,8,84069,156931,2010,MI,241000,120501
354,8,9,125730,119325,2010,MI,245055,122528
355,9,10,58530,168364,2010,MI,226894,113448
356,10,11,91710,141224,2010,MI,232934,116468
357,11,12,124671,71372,2010,MI,196043,98022
358,12,13,100885,23462,2010,MI,124347,62174
359,13,14,115511,29902,2010,MI,145413,72707
360,14,15,118336,83488,2010,MI,201824,100913
361,0,1,104428,100219,2010,IA,204647,102324
362,1,2,115839,104319,2010,IA,220158,110080
363,2,3,122147,111925,2010,IA,234072,117037
364,3,4,74300,152588,2010,IA,226888,113445
365,4,5,63160,128363,2010,IA,191523,95762
366,0,1,99233,112816,2010,AZ,212049,106025
367,1,2,82891,173173,2010,AZ,256064,128033
368,2,3,85610,108689,2010,AZ,194299,97150
369,3,4,61524,25300,2010,AZ,86824,43413
370,4,5,91749,110374,2010,AZ,202123,101062
371,5,6,72615,165649,2010,AZ,238264,119133
372,6,7,79935,70385,2010,AZ,150320,75161
373,7,8,138280,134124,2010,AZ,272404,136203
374,0,1,112010,104215,2010,NM,216225,108113
375,1,2,75708,94053,2010,NM,169761,84881
376,2,3,120048,90617,2010,NM,210665,105333
377,2,1,67008,152755,2010,SC,219763,109882
378,3,2,113625,138861,2010,SC,252486,126244
379,4,3,66497,126235,2010,SC,192732,96367
380,5,4,62438,137586,2010,SC,200024,100013
381,6,5,102296,125834,2010,SC,228130,114066
382,7,6,125459,72661,2010,SC,198120,99061
383,0,1,0,151173,2010,OK,151173,75587
384,1,2,108203,83226,2010,OK,191429,95715
385,2,3,45689,161927,2010,OK,207616,103809
386,3,4,0,1,2010,OK,1,1
387,4,5,68074,123236,2010,OK,191310,95656
388,0,1,26045,123006,2010,TN,149051,74526
389,1,2,25400,141796,2010,TN,167196,83599
390,2,3,45387,92032,2010,TN,137419,68710
391,3,4,70254,103969,2010,TN,174223,87112
392,4,5,99162,74204,2010,TN,173366,86684
393,5,6,56145,128517,2010,TN,184662,92332
394,6,7,54347,158916,2010,TN,213263,106632
395,7,8,64960,98759,2010,TN,163719,81860
396,8,9,99827,33879,2010,TN,133706,66854
397,8,1,98316,78300,2010,NY,176616,88309
398,9,2,94594,58525,2010,NY,153119,76560
399,10,3,51346,131674,2010,NY,183020,91511
400,11,4,94483,69323,2010,NY,163806,81904
401,12,5,72239,36861,2010,NY,109100,54551
402,13,6,85096,10057,2010,NY,95153,47577
403,14,7,71247,13751,2010,NY,84998,42500
404,15,8,98839,29514,2010,NY,128353,64177
405,16,9,67011,37750,2010,NY,104761,52381
406,17,10,95485,7419,2010,NY,102904,51453
407,18,11,104297,9119,2010,NY,113416,56709
408,19,12,68624,0,2010,NY,68624,34313
409,20,13,60773,55821,2010,NY,116594,58298
410,21,14,107327,32065,2010,NY,139392,69697
411,22,15,91225,10678,2010,NY,101903,50952
412,23,16,61642,2257,2010,NY,63899,31950
413,24,17,95346,29792,2010,NY,125138,62570
414,25,18,115619,60513,2010,NY,176132,88067
415,26,19,98766,88734,2010,NY,187500,93751
416,27,20,107075,110813,2010,NY,217888,108945
417,28,21,124889,70211,2010,NY,195100,97551
418,29,22,98661,75558,2010,NY,174219,87110
419,30,23,82232,73646,2010,NY,155878,77940
420,31,24,89809,85702,2010,NY,175511,87756
421,32,25,103954,81380,2010,NY,185334,92668
422,33,26,54307,151449,2010,NY,205756,102879
423,34,27,119085,63015,2010,NY,182100,91051
424,35,28,102514,45630,2010,NY,148144,74073
425,36,29,0,93167,2010,NY,93167,46584
426,0,1,172642,126737,2010,WA,299379,149690
427,1,2,155241,148722,2010,WA,303963,151982
428,2,3,135654,152799,2010,WA,288453,144227
429,3,4,74973,156726,2010,WA,231699,115850
430,4,5,101146,177235,2010,WA,278381,139191
431,5,6,151873,109800,2010,WA,261673,130837
432,6,7,232649,0,2010,WA,232649,116325
433,7,8,148581,161296,2010,WA,309877,154939
434,8,9,123743,101851,2010,WA,225594,112798
0,0,1,116949,211825,2020,AL,328774,164388
1,1,2,105286,197996,2020,AL,303282,151642
2,2,3,104595,217384,2020,AL,321979,160990
3,3,4,56237,261553,2020,AL,317790,158896
4,4,5,0,253094,2020,AL,253094,126548
5,5,6,0,274160,2020,AL,274160,137081
6,6,7,225742,0,2020,AL,225742,112872
7,11,1,146068,191112,2020,AK,337180,168591
8,13,1,188469,176709,2020,AR,365178,182590
9,14,2,209945,170975,2020,AR,380920,190461
10,15,3,174243,95594,2020,AR,269837,134919
11,16,4,120484,278002,2020,AR,398486,199244
12,17,5,183171,262414,2020,AR,445585,222793
13,18,6,199644,217783,2020,AR,417427,208714
14,19,7,165452,50226,2020,AR,215678,107840
15,20,8,170816,251633,2020,AR,422449,211225
16,21,9,217094,135180,2020,AR,352274,176138
17,25,1,0,237596,2020,AR,237596,118799
18,26,2,148410,184093,2020,AR,332503,166252
19,27,3,106325,214960,2020,AR,321285,160643
20,28,4,75750,191617,2020,AR,267367,133684
21,32,1,154073,204190,2020,CA,358263,179132
22,33,2,294435,94320,2020,CA,388755,194378
23,34,3,176043,145945,2020,CA,321988,160995
24,35,4,194731,247291,2020,CA,442022,221012
25,36,5,271233,85227,2020,CA,356460,178231
26,37,6,229648,83466,2020,CA,313114,156558
27,38,7,217416,166549,2020,CA,383965,191983
28,39,8,124400,158711,2020,CA,283111,141556
29,40,9,174252,128358,2020,CA,302610,151306
30,41,10,166865,135629,2020,CA,302494,151248
31,42,11,271063,100293,2020,CA,371356,185679
32,43,12,362950,0,2020,CA,362950,181476
33,44,13,327863,34955,2020,CA,362818,181410
34,45,14,278300,72705,2020,CA,351005,175503
35,46,15,242991,99710,2020,CA,342701,171351
36,47,16,128690,88039,2020,CA,216729,108365
37,48,17,212137,85199,2020,CA,297336,148669
38,49,18,344139,0,2020,CA,344139,172070
39,50,19,224385,88642,2020,CA,313027,156514
40,51,20,236896,71658,2020,CA,308554,154278
41,52,21,84406,85928,2020,CA,170334,85168
42,53,22,144251,170888,2020,CA,315139,157570
43,54,23,115896,190222,2020,CA,306118,153060
44,55,24,212564,149781,2020,CA,362345,181173
45,56,25,169305,169638,2020,CA,338943,169472
46,57,26,208856,135877,2020,CA,344733,172367
47,58,27,221411,95907,2020,CA,317318,158660
48,59,28,244271,91928,2020,CA,336199,168100
49,60,29,210944,0,2020,CA,210944,105473
50,61,30,240038,105426,2020,CA,345464,172733
51,62,31,175315,110735,2020,CA,286050,143026
52,63,32,172942,86818,2020,CA,259760,129881
53,64,33,257094,123334,2020,CA,380428,190215
54,65,34,205346,0,2020,CA,205346,102674
55,66,35,169405,74941,2020,CA,244346,122174
56,67,36,185151,121698,2020,CA,306849,153425
57,68,37,254916,41705,2020,CA,296621,148311
58,69,38,256206,0,2020,CA,256206,128104
59,70,39,169837,173946,2020,CA,343783,171892
60,71,40,135572,50809,2020,CA,186381,93191
61,72,41,168126,94447,2020,CA,262573,131287
62,73,42,157773,210274,2020,CA,368047,184024
63,74,43,199210,78688,2020,CA,277898,138950
64,75,44,206036,0,2020,CA,206036,103019
65,76,45,221843,193096,2020,CA,414939,207470
66,77,46,157803,71716,2020,CA,229519,114760
67,78,47,197028,114371,2020,CA,311399,155700
68,79,48,193362,201738,2020,CA,395100,197551
69,80,49,205349,181157,2020,CA,386506,193254
70,81,50,166869,195521,2020,CA,362390,181196
71,82,51,165596,76841,2020,CA,242437,121219
72,83,52,244145,152350,2020,CA,396495,198248
73,84,53,334858,0,2020,CA,334858,167430
74,87,1,331621,105955,2020,CO,437576,218789
75,88,2,316925,182547,2020,CO,499472,249737
76,89,3,194122,220634,2020,CO,414756,207379
77,90,4,173945,285606,2020,CO,459551,229776
78,91,5,161600,249013,2020,CO,410613,205307
79,92,6,250314,175192,2020,CO,425506,212754
80,93,7,250525,159301,2020,CO,409826,204914
81,97,1,213001,122111,2020,CT,335112,167557
82,98,2,207303,140356,2020,CT,347659,173830
83,99,3,194259,131568,2020,CT,325827,162914
84,100,4,224432,130627,2020,CT,355059,177530
85,101,5,183797,151988,2020,CT,335785,167893
86,104,1,281382,196392,2020,DE,477774,238888
87,107,1,149172,283352,2020,FL,432524,216263
88,108,2,0,305337,2020,FL,305337,152669
89,109,3,167326,223075,2020,FL,390401,195201
90,110,4,196423,308497,2020,FL,504920,252461
91,111,5,219463,117510,2020,FL,336973,168487
92,112,6,172305,265393,2020,FL,437698,218850
93,113,7,224946,175750,2020,FL,400696,200349
94,114,8,177695,282093,2020,FL,459788,229895
95,115,9,240724,188889,2020,FL,429613,214807
96,116,10,239434,136889,2020,FL,376323,188162
97,117,11,158094,316979,2020,FL,475073,237537
98,118,12,168194,284941,2020,FL,453135,226568
99,119,13,215405,190713,2020,FL,406118,203060
100,120,14,224240,147896,2020,FL,372136,186069
101,121,15,174297,216374,2020,FL,390671,195336
102,122,16,215683,269001,2020,FL,484684,242343
103,123,17,140487,266514,2020,FL,407001,203501
104,124,18,186674,253286,2020,FL,439960,219981
105,125,19,172146,272440,2020,FL,444586,222294
106,126,20,253661,68748,2020,FL,322409,161205
107,127,21,237925,157612,2020,FL,395537,197769
108,128,22,235764,166553,2020,FL,402317,201159
109,129,23,221239,158874,2020,FL,380113,190057
110,130,24,218825,59084,2020,FL,277909,138955
111,131,25,0,1,2020,FL,1,1
112,132,26,165407,177223,2020,FL,342630,171316
113,133,27,166758,176141,2020,FL,342899,171450
114,136,1,135238,189457,2020,GA,324695,162348
115,137,2,161397,111620,2020,GA,273017,136509
116,138,3,129792,241526,2020,GA,371318,185660
117,139,4,278906,69393,2020,GA,348299,174150
118,140,5,301857,52646,2020,GA,354503,177252
119,141,6,216775,180329,2020,GA,397104,198553
120,142,7,190900,180564,2020,GA,371464,185733
121,143,8,109264,198701,2020,GA,307965,153983
122,144,9,79797,292750,2020,GA,372547,186274
123,145,10,142636,235810,2020,GA,378446,189224
124,146,11,160623,245259,2020,GA,405882,202942
125,147,12,129061,181038,2020,GA,310099,155050
126,148,13,279045,81476,2020,GA,360521,180261
127,149,14,77798,229827,2020,GA,307625,153813
128,153,1,183245,71188,2020,HI,254433,127217
129,154,2,171517,84027,2020,HI,255544,127773
130,157,1,131380,310736,2020,ID,442116,221059
131,158,2,124151,250669,2020,ID,374820,187411
132,162,1,239943,85027,2020,IL,324970,162486
133,163,2,234896,63142,2020,IL,298038,149020
134,164,3,172997,133851,2020,IL,306848,153425
135,165,4,187219,35518,2020,IL,222737,111369
136,166,5,255661,96200,2020,IL,351861,175931
137,167,6,213777,183891,2020,IL,397668,198835
138,168,7,249383,41390,2020,IL,290773,145387
139,169,8,186251,0,2020,IL,186251,93126
140,170,9,262045,107125,2020,IL,369170,184586
141,171,10,202402,114442,2020,IL,316844,158423
142,172,11,194557,112807,2020,IL,307364,153683
143,173,12,127577,194839,2020,IL,322416,161209
144,174,13,151648,181373,2020,IL,333021,166511
145,175,14,203209,197835,2020,IL,401044,200523
146,176,15,88559,244947,2020,IL,333506,166754
147,177,16,119313,218839,2020,IL,338152,169077
148,178,17,156011,143863,2020,IL,299874,149938
149,179,18,110039,261840,2020,IL,371879,185940
150,183,1,185180,132247,2020,IN,317427,158714
151,184,2,114967,183601,2020,IN,298568,149285
152,185,3,104762,220989,2020,IN,325751,162876
153,186,4,112984,225531,2020,IN,338515,169258
154,187,5,191226,208212,2020,IN,399438,199720
155,188,6,91103,225319,2020,IN,316422,158212
156,189,7,176422,106146,2020,IN,282568,141285
157,190,8,95691,214643,2020,IN,310334,155168
158,191,9,122566,222057,2020,IN,344623,172312
159,194,1,201347,212088,2020,IA,413435,206718
160,195,2,196958,196964,2020,IA,393922,196962
161,196,3,219205,212997,2020,IA,432202,216102
162,197,4,144761,237369,2020,IA,382130,191066
163,201,1,84393,208229,2020,KS,292622,146312
164,202,2,136650,185464,2020,KS,322114,161058
165,203,3,220049,178773,2020,KS,398822,199412
166,204,4,116166,203432,2020,KS,319598,159800
167,208,1,82141,246329,2020,KY,328470,164236
168,209,2,94643,255735,2020,KY,350378,175190
169,210,3,230672,137425,2020,KY,368097,184049
170,211,4,125896,256613,2020,KY,382509,191255
171,212,5,47056,250914,2020,KY,297970,148986
172,213,6,155011,216948,2020,KY,371959,185980
173,217,1,94730,270330,2020,LA,365060,182531
174,218,2,235320,63140,2020,LA,298460,149231
175,219,3,100275,230480,2020,LA,330755,165378
176,220,4,101970,204608,2020,LA,306578,153290
177,221,5,99566,135524,2020,LA,235090,117546
178,222,6,95541,265706,2020,LA,361247,180624
179,226,1,271004,165008,2020,ME,436012,218007
180,227,2,197974,175228,2020,ME,373202,186602
181,231,1,143877,250901,2020,MD,394778,197390
182,232,2,224836,106355,2020,MD,331191,165596
183,233,3,260358,112117,2020,MD,372475,186238
184,234,4,282119,71671,2020,MD,353790,176896
185,235,5,274210,123525,2020,MD,397735,198868
186,236,6,215540,143599,2020,MD,359139,179570
187,237,7,237084,92825,2020,MD,329909,164955
188,238,8,274716,127157,2020,MD,401873,200937
189,241,1,275376,0,2020,MA,275376,137689
190,242,2,249854,132220,2020,MA,382074,191038
191,243,3,286896,0,2020,MA,286896,143449
192,244,4,251102,160474,2020,MA,411576,205789
193,245,5,294427,101351,2020,MA,395778,197890
194,246,6,286377,150695,2020,MA,437072,218537
195,247,7,267362,0,2020,MA,267362,133682
196,248,8,310940,0,2020,MA,310940,155471
197,249,9,260262,154261,2020,MA,414523,207262
198,253,1,153328,256581,2020,MI,409909,204955
199,254,2,154122,238711,2020,MI,392833,196417
200,255,3,189769,213649,2020,MI,403418,201710
201,256,4,120802,242621,2020,MI,363423,181712
202,257,5,196599,150772,2020,MI,347371,173686
203,258,6,152085,211496,2020,MI,363581,181791
204,259,7,159743,227524,2020,MI,387267,193634
205,260,8,217922,202525,2020,MI,420447,210224
206,261,9,230318,153296,2020,MI,383614,191808
207,262,10,138179,271607,2020,MI,409786,204894
208,263,11,226128,215405,2020,MI,441533,220767
209,264,12,254957,117719,2020,MI,372676,186339
210,265,13,223205,53311,2020,MI,276516,138259
211,266,14,271370,62664,2020,MI,334034,167018
212,270,1,0,179234,2020,MN,179234,89618
213,271,2,204534,194954,2020,MN,399488,199745
214,272,3,246666,196625,2020,MN,443291,221646
215,273,4,245813,112730,2020,MN,358543,179272
216,274,5,255924,102878,2020,MN,358802,179402
217,275,6,0,270901,2020,MN,270901,135451
218,276,7,144840,194066,2020,MN,338906,169454
219,277,8,0,223432,2020,MN,223432,111717
220,281,1,104008,228787,2020,MS,332795,166398
221,282,2,196224,101010,2020,MS,297234,148618
222,283,3,120782,221064,2020,MS,341846,170924
223,284,4,0,255971,2020,MS,255971,127986
224,288,1,249087,59940,2020,MO,309027,154514
225,289,2,204540,233157,2020,MO,437697,218849
226,290,3,116095,282866,2020,MO,398961,199481
227,291,4,107635,245247,2020,MO,352882,176442
228,292,5,207180,135934,2020,MO,343114,171558
229,293,6,118926,258709,2020,MO,377635,188818
230,294,7,98111,254318,2020,MO,352429,176215
231,295,8,70561,253811,2020,MO,324372,162187
232,298,1,262340,339169,2020,MT,601509,300755
233,301,1,119622,189006,2020,NE,308628,154315
234,302,2,155706,171071,2020,NE,326777,163389
235,303,3,50690,225157,2020,NE,275847,137924
236,307,1,137868,74490,2020,NV,212358,106180
237,308,2,155780,216078,2020,NV,371858,185930
238,309,3,203421,190975,2020,NV,394396,197199
239,310,4,168457,152284,2020,NV,320741,160371
240,313,1,205606,185159,2020,NH,390765,195383
241,314,2,208289,168886,2020,NH,377175,188588
242,319,2,173849,195526,2020,NJ,369375,184688
243,320,3,229840,196327,2020,NJ,426167,213084
244,321,4,162420,254103,2020,NJ,416523,208262
245,322,5,225175,193333,2020,NJ,418508,209255
246,323,6,199648,126760,2020,NJ,326408,163205
247,324,7,219629,214318,2020,NJ,433947,216974
248,325,8,176758,58686,2020,NJ,235444,117723
249,326,9,203674,98629,2020,NJ,302303,151152
250,327,10,241522,40298,2020,NJ,281820,140911
251,328,11,235163,206013,2020,NJ,441176,220589
252,329,12,230883,114591,2020,NJ,345474,172738
253,333,1,186953,134337,2020,NM,321290,160646
254,334,2,122546,142283,2020,NM,264829,132415
255,335,3,186282,131166,2020,NM,317448,158725
256,339,1,149724,175775,2020,NY,325499,162750
257,340,2,144737,158130,2020,NY,302867,151434
258,341,3,195927,147437,2020,NY,343364,171683
259,342,4,199762,139559,2020,NY,339321,169661
260,343,5,229125,0,2020,NY,229125,114563
261,344,6,144149,67735,2020,NY,211884,105943
262,345,7,156889,29404,2020,NY,186293,93147
263,346,8,207111,39124,2020,NY,246235,123118
264,347,9,195758,40110,2020,NY,235868,117935
265,348,10,181215,61045,2020,NY,242260,121131
266,349,11,134625,143420,2020,NY,278045,139023
267,350,12,265172,49157,2020,NY,314329,157165
268,351,13,202916,19829,2020,NY,222745,111373
269,352,14,152661,52477,2020,NY,205138,102570
270,353,15,169533,18984,2020,NY,188517,94259
271,354,16,218471,0,2020,NY,218471,109236
272,355,17,183975,117307,2020,NY,301282,150642
273,356,18,170899,128568,2020,NY,299467,149734
274,357,19,168281,151475,2020,NY,319756,159879
275,358,20,194071,120839,2020,NY,314910,157456
276,359,21,122419,169679,2020,NY,292098,146050
277,360,22,138898,143291,2020,NY,282189,141095
278,361,23,116062,161830,2020,NY,277892,138947
279,362,24,147638,156025,2020,NY,303663,151832
280,363,25,187503,115940,2020,NY,303443,151722
281,364,26,202315,91687,2020,NY,294002,147002
282,365,27,136783,192756,2020,NY,329539,164770
283,368,1,188870,159748,2020,NC,348618,174310
284,369,2,311887,172544,2020,NC,484431,242216
285,370,3,132752,229800,2020,NC,362552,181277
286,371,4,332421,161298,2020,NC,493719,246860
287,372,5,119846,257843,2020,NC,377689,188845
288,373,6,253531,153598,2020,NC,407129,203565
289,374,7,179045,272443,2020,NC,451488,225745
290,375,8,177781,202774,2020,NC,380555,190278
291,376,9,179463,224661,2020,NC,404124,202063
292,377,10,128189,284095,2020,NC,412284,206143
293,378,11,190609,245351,2020,NC,435960,217981
294,379,12,341457,0,2020,NC,341457,170729
295,380,13,124684,267181,2020,NC,391865,195933
296,384,1,0,245229,2020,ND,245229,122615
297,386,1,172022,199560,2020,OH,371582,185792
298,387,2,146781,230430,2020,OH,377211,188606
299,388,3,227420,93569,2020,OH,320989,160495
300,389,4,101897,235875,2020,OH,337772,168887
301,390,5,120962,257019,2020,OH,377981,188991
302,391,6,85661,249130,2020,OH,334791,167396
303,392,7,102271,236607,2020,OH,338878,169440
304,393,8,110766,246277,2020,OH,357043,178522
305,394,9,190328,111385,2020,OH,301713,150857
306,395,10,151976,212972,2020,OH,364948,182475
307,396,11,242098,60323,2020,OH,302421,151211
308,397,12,182847,241790,2020,OH,424637,212319
309,398,13,173631,148648,2020,OH,322279,161140
310,399,14,158586,238864,2020,OH,397450,198726
311,400,15,140183,243103,2020,OH,383286,191644
312,401,16,144071,247335,2020,OH,391406,195704
313,404,1,109641,213700,2020,OK,323341,161671
314,405,2,63472,216511,2020,OK,279983,139992
315,406,3,66501,242677,2020,OK,309178,154590
316,407,4,90459,213096,2020,OK,303555,151778
317,408,5,145658,158191,2020,OK,303849,151925
318,409,,475731,1044175,2020,OK,1519906,759954
319,412,1,297071,161928,2020,OR,458999,229500
320,413,2,168881,273835,2020,OR,442716,221359
321,414,3,343574,110570,2020,OR,454144,227073
322,415,4,240950,216081,2020,OR,457031,228516
323,416,5,234863,204372,2020,OR,439235,219618
324,420,1,191875,249804,2020,PA,441679,220840
325,421,2,198140,75022,2020,PA,273162,136582
326,422,3,341708,33671,2020,PA,375379,187690
327,423,4,264637,179926,2020,PA,444563,222282
328,424,5,255743,139552,2020,PA,395295,197648
329,425,6,226440,177526,2020,PA,403966,201984
330,426,7,195475,181407,2020,PA,376882,188442
331,427,8,178004,165783,2020,PA,343787,171894
332,428,9,118266,232988,2020,PA,351254,175628
333,429,10,182938,208896,2020,PA,391834,195918
334,430,11,141325,241915,2020,PA,383240,191621
335,431,12,99199,241035,2020,PA,340234,170118
336,432,13,96612,267789,2020,PA,364401,182201
337,433,14,131895,241688,2020,PA,373583,186792
338,434,15,92156,255058,2020,PA,347214,173608
339,435,16,143962,210088,2020,PA,354050,177026
340,436,17,222253,212284,2020,PA,434537,217269
341,437,18,266084,118163,2020,PA,384247,192124
342,440,1,158550,0,2020,RI,158550,79276
343,441,2,154086,109894,2020,RI,263980,131991
344,445,1,210627,216042,2020,SC,426669,213335
345,446,2,155118,202715,2020,SC,357833,178917
346,447,3,95712,237544,2020,SC,333256,166629
347,448,4,133023,222126,2020,SC,355149,177575
348,449,5,145979,220006,2020,SC,365985,182993
349,450,6,197477,89258,2020,SC,286735,143368
350,451,7,138863,224993,2020,SC,363856,181929
351,456,1,143987,276232,2020,SD,420219,210110
352,458,1,68617,228181,2020,TN,296798,148400
353,459,2,109684,238907,2020,TN,348591,174296
354,460,3,97687,215571,2020,TN,313258,156630
355,461,4,111908,223802,2020,TN,335710,167856
356,462,5,252155,0,2020,TN,252155,126078
357,463,6,83852,257572,2020,TN,341424,170713
358,464,7,95839,245188,2020,TN,341027,170514
359,465,8,97890,227216,2020,TN,325106,162554
360,466,9,187905,48818,2020,TN,236723,118362
361,470,1,83016,219726,2020,TX,302742,151372
362,471,2,148374,192828,2020,TX,341202,170602
363,472,3,179458,230512,2020,TX,409970,204986
364,473,4,76326,253837,2020,TX,330163,165082
365,474,5,100743,173836,2020,TX,274579,137290
366,475,6,149530,179507,2020,TX,329037,164519
367,476,7,159529,149054,2020,TX,308583,154292
368,477,8,97409,277327,2020,TX,374736,187369
369,478,9,172938,49575,2020,TX,222513,111257
370,479,10,187686,217216,2020,TX,404902,202452
371,480,11,53394,232568,2020,TX,285962,142982
372,481,12,121250,233853,2020,TX,355103,177552
373,482,13,50477,217124,2020,TX,267601,133801
374,483,14,118574,190541,2020,TX,309115,154558
375,484,15,115605,109017,2020,TX,224622,112312
376,485,16,154108,84006,2020,TX,238114,119058
377,486,17,125565,171390,2020,TX,296955,148478
378,487,18,180952,58033,2020,TX,238985,119493
379,488,19,60583,198198,2020,TX,258781,129391
380,489,20,175078,89628,2020,TX,264706,132354
381,490,21,205780,235740,2020,TX,441520,220761
382,491,22,181998,210259,2020,TX,392257,196129
383,492,23,137693,149395,2020,TX,287088,143545
384,493,24,163326,167910,2020,TX,331236,165619
385,494,25,165697,220088,2020,TX,385785,192893
386,495,26,161009,261963,2020,TX,422972,211487
387,496,27,95466,172305,2020,TX,267771,133886
388,497,28,137494,91925,2020,TX,229419,114710
389,498,29,111305,42840,2020,TX,154145,77073
390,499,30,204928,48685,2020,TX,253613,126807
391,500,31,176293,212695,2020,TX,388988,194495
392,501,32,178542,157867,2020,TX,336409,168205
393,502,33,105317,39638,2020,TX,144955,72478
394,503,34,111439,84119,2020,TX,195558,97780
395,504,35,176373,80795,2020,TX,257168,128585
396,505,36,73418,222712,2020,TX,296130,148066
397,509,1,104194,237988,2020,UT,342182,171092
398,510,2,129762,208997,2020,UT,338759,169380
399,511,3,96067,246674,2020,UT,342741,171371
400,512,4,175923,179688,2020,UT,355611,177806
401,515,1,238827,95830,2020,VT,334657,167329
402,517,1,186923,260614,2020,VA,447537,223769
403,518,2,185733,165031,2020,VA,350764,175383
404,519,3,233326,107299,2020,VA,340625,170313
405,520,4,241142,149625,2020,VA,390767,195384
406,521,5,190315,210988,2020,VA,401303,200652
407,522,6,134729,246606,2020,VA,381335,190668
408,523,7,230893,222623,2020,VA,453516,226759
409,524,8,301454,95365,2020,VA,396819,198410
410,525,9,0,271851,2020,VA,271851,135926
411,526,10,268734,206253,2020,VA,474987,237494
412,527,11,280725,111380,2020,VA,392105,196053
413,531,1,249944,176407,2020,WA,426351,213176
414,532,2,255252,148384,2020,WA,403636,201819
415,533,3,181347,235579,2020,WA,416926,208464
416,534,4,102667,202108,2020,WA,304775,152388
417,535,5,155737,247815,2020,WA,403552,201777
418,536,6,247429,168783,2020,WA,416212,208107
419,537,7,387109,78240,2020,WA,465349,232675
420,538,8,213123,198423,2020,WA,411546,205774
421,539,9,258771,89697,2020,WA,348468,174235
422,540,10,288977,0,2020,WA,288977,144489
423,543,1,81177,180488,2020,WV,261665,130833
424,544,2,100799,172195,2020,WV,272994,136498
425,545,3,64927,161585,2020,WV,226512,113257
426,549,1,163170,238271,2020,WI,401441,200721
427,550,2,318523,138306,2020,WI,456829,228415
428,551,3,199870,189524,2020,WI,389394,194698
429,552,4,232668,70769,2020,WI,303437,151719
430,553,5,175902,265434,2020,WI,441336,220669
431,554,6,164239,238874,2020,WI,403113,201557
432,555,7,162741,252048,2020,WI,414789,207395
433,556,8,149558,268173,2020,WI,417731,208866
434,559,1,66576,185732,2020,WY,252308,126155
0,0,1,0,208083,2016,AL,208083,104042
1,1,2,112089,134886,2016,AL,246975,123488
2,2,3,94549,192164,2016,AL,286713,143357
3,3,4,0,235925,2016,AL,235925,117963
4,4,5,102234,205647,2016,AL,307881,153941
5,5,6,83709,245313,2016,AL,329022,164512
6,6,7,229330,0,2016,AL,229330,114666
7,10,1,111019,155088,2016,AK,266107,133054
8,13,1,142219,121745,2016,AZ,263964,131983
9,14,2,135873,179806,2016,AZ,315679,157840
10,15,3,148973,0,2016,AZ,148973,74487
11,16,4,81296,203487,2016,AZ,284783,142392
12,17,5,114940,205184,2016,AZ,320124,160063
13,18,6,122866,201578,2016,AZ,324444,162223
14,19,7,119465,39286,2016,AZ,158751,79376
15,20,8,0,204942,2016,AZ,204942,102472
16,21,9,169055,108350,2016,AZ,277405,138703
17,25,1,0,183866,2016,AR,183866,91934
18,26,2,111347,176472,2016,AR,287819,143910
19,27,3,0,217192,2016,AR,217192,108597
20,28,4,0,182885,2016,AR,182885,91443
21,32,1,128588,185448,2016,CA,314036,157019
22,33,2,254194,76572,2016,CA,330766,165384
23,34,3,152513,104453,2016,CA,256966,128484
24,35,4,130845,220133,2016,CA,350978,175490
25,36,5,224526,67565,2016,CA,292091,146046
26,37,6,177565,57848,2016,CA,235413,117707
27,38,7,152133,145168,2016,CA,297301,148651
28,39,8,83035,136972,2016,CA,220007,110004
29,40,9,133163,98992,2016,CA,232155,116078
30,41,10,116470,124671,2016,CA,241141,120571
31,42,11,214868,83341,2016,CA,298209,149105
32,43,12,274035,0,2016,CA,274035,137018
33,44,13,293117,29754,2016,CA,322871,161436
34,45,14,231630,54817,2016,CA,286447,143224
35,46,15,198578,70619,2016,CA,269197,134599
36,47,16,97473,70483,2016,CA,167956,83979
37,48,17,233192,0,2016,CA,233192,116597
38,49,18,230460,93470,2016,CA,323930,161966
39,50,19,181802,64061,2016,CA,245863,122932
40,51,20,180980,74811,2016,CA,255791,127896
41,52,21,57282,75126,2016,CA,132408,66205
42,53,22,76211,158755,2016,CA,234966,117484
43,54,23,74468,167116,2016,CA,241584,120793
44,55,24,166034,144780,2016,CA,310814,155408
45,56,25,122406,138755,2016,CA,261161,130581
46,57,26,169248,111059,2016,CA,280307,140154
47,58,27,168977,81655,2016,CA,250632,125317
48,59,28,210883,59526,2016,CA,270409,135205
49,60,29,171824,0,2016,CA,171824,85913
50,61,30,205279,77325,2016,CA,282604,141303
51,62,31,121070,94866,2016,CA,215936,107969
52,63,32,186646,0,2016,CA,186646,93324
53,64,33,219397,110822,2016,CA,330219,165110
54,65,34,159156,0,2016,CA,159156,79579
55,66,35,124044,47309,2016,CA,171353,85677
56,67,36,144348,88269,2016,CA,232617,116309
57,68,37,237272,0,2016,CA,237272,118637
58,69,38,163590,68524,2016,CA,232114,116058
59,70,39,112679,150777,2016,CA,263456,131729
60,71,40,106554,0,2016,CA,106554,53278
61,72,41,128164,69159,2016,CA,197323,98662
62,73,42,104689,149547,2016,CA,254236,127119
63,74,43,167017,52499,2016,CA,219516,109759
64,75,44,178413,0,2016,CA,178413,89207
65,76,45,129231,182618,2016,CA,311849,155925
66,77,46,164593,0,2016,CA,164593,82297
67,78,47,154759,88109,2016,CA,242868,121435
68,79,48,127715,178701,2016,CA,306416,153209
69,80,49,154267,155888,2016,CA,310155,155078
70,81,50,103646,179937,2016,CA,283583,141792
71,82,51,145162,54362,2016,CA,199524,99763
72,83,52,181253,139403,2016,CA,320656,160329
73,84,53,198988,97968,2016,CA,296956,148479
74,88,1,257254,105030,2016,CO,362284,181143
75,89,2,260175,170001,2016,CO,430176,215089
76,90,3,150914,204220,2016,CO,355134,177568
77,91,4,123642,248230,2016,CO,371872,185937
78,92,5,111676,225445,2016,CO,337121,168561
79,93,6,160372,191626,2016,CO,351998,176000
80,94,7,199758,144066,2016,CO,343824,171913
81,98,1,187021,105674,2016,CT,292695,146348
82,99,2,186210,111149,2016,CT,297359,148680
83,100,3,192274,95786,2016,CT,288060,144031
84,101,4,187811,120653,2016,CT,308464,154233
85,102,5,163499,124900,2016,CT,288399,144200
86,106,1,233554,172301,2016,DE,405855,202928
87,108,1,114079,255107,2016,FL,369186,184594
88,109,2,102801,231163,2016,FL,333964,166983
89,110,3,136338,193843,2016,FL,330181,165091
90,111,4,113088,287509,2016,FL,400597,200299
91,112,5,194549,108325,2016,FL,302874,151438
92,113,6,151051,213519,2016,FL,364570,182286
93,114,7,182039,171583,2016,FL,353622,176812
94,115,8,127127,246483,2016,FL,373610,186806
95,116,9,195311,144450,2016,FL,339761,169881
96,117,10,198491,107498,2016,FL,305989,152995
97,118,11,124713,258016,2016,FL,382729,191365
98,119,12,116110,253559,2016,FL,369669,184835
99,120,13,184693,171149,2016,FL,355842,177922
100,121,14,195789,121088,2016,FL,316877,158439
101,122,15,135475,182999,2016,FL,318474,159238
102,123,16,155262,230654,2016,FL,385916,192959
103,124,17,115974,209348,2016,FL,325322,162662
104,125,18,161918,201488,2016,FL,363406,181704
105,126,19,123812,239225,2016,FL,363037,181519
106,127,20,222914,54646,2016,FL,277560,138781
107,128,21,210606,118038,2016,FL,328644,164323
108,129,22,199113,138737,2016,FL,337850,168926
109,130,23,183225,130818,2016,FL,314043,157022
110,131,24,1,0,2016,FL,1,1
111,132,25,95319,157921,2016,FL,253240,126621
112,133,26,115493,148547,2016,FL,264040,132021
113,134,27,129760,157917,2016,FL,287677,143839
114,138,1,0,210243,2016,FL,210243,105122
115,139,2,148543,94056,2016,FL,242599,121300
116,140,3,95969,207218,2016,FL,303187,151594
117,141,4,220146,70593,2016,GA,290739,145370
118,142,5,253781,46768,2016,GA,300549,150275
119,143,6,124917,201088,2016,GA,326005,163003
120,144,7,114220,174081,2016,GA,288301,144151
121,145,8,83225,173983,2016,GA,257208,128605
122,146,9,0,256535,2016,GA,256535,128268
123,147,10,0,243725,2016,GA,243725,121863
124,148,11,105383,217935,2016,GA,323318,161660
125,149,12,99420,159492,2016,GA,258912,129457
126,150,13,252833,0,2016,GA,252833,126417
127,151,14,0,216743,2016,GA,216743,108372
128,155,1,145417,45958,2016,HI,191375,95688
129,156,2,170848,39668,2016,HI,210516,105259
130,160,1,113052,242252,2016,ID,355304,177653
131,161,2,95940,205292,2016,ID,301232,150617
132,165,1,234037,81817,2016,IL,315854,157928
133,166,2,235051,59471,2016,IL,294522,147262
134,167,3,225320,0,2016,IL,225320,112661
135,168,4,171297,0,2016,IL,171297,85649
136,169,5,212842,86222,2016,IL,299064,149533
137,170,6,143591,208555,2016,IL,352146,176074
138,171,7,250584,46882,2016,IL,297466,148734
139,172,8,144954,103617,2016,IL,248571,124286
140,173,9,217306,109550,2016,IL,326856,163429
141,174,10,150435,135535,2016,IL,285970,142986
142,175,11,166578,108995,2016,IL,275573,137787
143,176,12,124246,169976,2016,IL,294222,147112
144,177,13,126811,187583,2016,IL,314394,157198
145,178,14,137589,200508,2016,IL,338097,169049
146,179,15,0,274554,2016,IL,274554,137278
147,180,16,0,259722,2016,IL,259722,129862
148,181,17,173125,113943,2016,IL,287068,143535
149,182,18,96770,250506,2016,IL,347276,173639
150,186,1,207515,0,2016,IN,207515,103758
151,187,2,102401,164355,2016,IN,266756,133379
152,188,3,66023,201396,2016,IN,267419,133710
153,189,4,91256,193412,2016,IN,284668,142335
154,190,5,123849,221957,2016,IN,345806,172904
155,191,6,79135,204920,2016,IN,284055,142028
156,192,7,158739,94456,2016,IN,253195,126598
157,193,8,93356,187702,2016,IN,281058,140530
158,194,9,130627,174791,2016,IN,305418,152710
159,198,1,177403,206903,2016,IA,384306,192154
160,199,2,198571,170933,2016,IA,369504,184753
161,200,3,155002,208598,2016,IA,363600,181801
162,201,4,142993,226719,2016,IA,369712,184857
163,205,1,0,169992,2016,KS,169992,84997
164,206,2,96840,181228,2016,KS,278068,139035
165,207,3,139300,176022,2016,KS,315322,157662
166,208,4,81495,166998,2016,KS,248493,124247
167,212,1,81710,216959,2016,KY,298669,149335
168,213,2,0,251825,2016,KY,251825,125913
169,214,3,212401,122093,2016,KY,334494,167248
170,215,4,94065,233922,2016,KY,327987,163994
171,216,5,0,221242,2016,KY,221242,110622
172,217,6,128728,202099,2016,KY,330827,165414
173,221,1,63785,243645,2016,LA,307430,153716
174,222,2,284269,0,2016,LA,284269,142135
175,223,3,56215,220621,2016,LA,276836,138419
176,224,4,46579,216540,2016,LA,263119,131560
177,225,5,0,255662,2016,LA,255662,127832
178,226,6,79202,241075,2016,LA,320277,160139
179,230,1,227546,164569,2016,ME,392115,196058
180,231,2,159081,192878,2016,ME,351959,175980
181,234,1,103622,242574,2016,MD,346196,173099
182,235,2,192183,102577,2016,MD,294760,147381
183,236,3,214640,115048,2016,MD,329688,164845
184,237,4,237501,68670,2016,MD,306171,153086
185,238,5,242989,105931,2016,MD,348920,174461
186,239,6,185770,133081,2016,MD,318851,159426
187,240,7,238838,69556,2016,MD,308394,154198
188,241,8,220657,124651,2016,MD,345308,172655
189,245,1,235803,0,2016,MA,235803,117902
190,246,2,275487,0,2016,MA,275487,137744
191,247,3,236713,107519,2016,MA,344232,172117
192,248,4,265823,113055,2016,MA,378878,189440
193,249,5,285606,0,2016,MA,285606,142804
194,250,6,308923,0,2016,MA,308923,154462
195,251,7,253354,0,2016,MA,253354,126678
196,252,8,271019,102744,2016,MA,373763,186882
197,253,9,211790,127803,2016,MA,339593,169797
198,256,1,144334,197777,2016,MI,342111,171056
199,257,2,110391,212508,2016,MI,322899,161450
200,258,3,128400,203545,2016,MI,331945,165973
201,259,4,101277,194572,2016,MI,295849,147925
202,260,5,195279,112102,2016,MI,307381,153691
203,261,6,119980,193259,2016,MI,313239,156620
204,262,7,134010,184321,2016,MI,318331,159166
205,263,8,143791,205629,2016,MI,349420,174711
206,264,9,199661,128937,2016,MI,328598,164300
207,265,10,110112,215132,2016,MI,325244,162623
208,266,11,152461,200872,2016,MI,353333,176667
209,267,12,211378,96104,2016,MI,307482,153742
210,268,13,198771,40541,2016,MI,239312,119657
211,269,14,244135,58103,2016,MI,302238,151120
212,272,1,169071,166524,2016,MN,335595,167798
213,273,2,0,173970,2016,MN,173970,86986
214,274,3,0,223075,2016,MN,223075,111538
215,275,4,203299,121033,2016,MN,324332,162167
216,276,5,249957,80660,2016,MN,330617,165309
217,277,6,0,235385,2016,MN,235385,117693
218,278,7,173572,156944,2016,MN,330516,165259
219,279,8,179097,177088,2016,MN,356185,178093
220,282,1,83947,206455,2016,MS,290402,145202
221,283,2,192343,83542,2016,MS,275885,137943
222,284,3,96101,209490,2016,MS,305591,152796
223,285,4,77505,181323,2016,MS,258828,129415
224,288,1,236993,62714,2016,MO,299707,149854
225,289,2,155689,241954,2016,MO,397643,198822
226,290,3,102891,249865,2016,MO,352756,176379
227,291,4,92510,225348,2016,MO,317858,158930
228,292,5,190766,123771,2016,MO,314537,157269
229,293,6,99692,238388,2016,MO,338080,169041
230,294,7,92756,228692,2016,MO,321448,160725
231,295,8,70009,229792,2016,MO,299801,149901
232,299,1,205919,285358,2016,MT,491277,245639
233,301,1,83467,189771,2016,NE,273238,136620
234,302,2,137602,141066,2016,NE,278668,139335
235,303,3,0,226720,2016,NE,226720,113361
236,306,1,116537,54174,2016,NV,170711,85356
237,307,2,115722,182676,2016,NV,298398,149200
238,308,3,146869,142926,2016,NV,289795,144898
239,309,4,128985,118328,2016,NV,247313,123657
240,313,1,162080,157176,2016,NH,319256,159629
241,314,2,174371,158825,2016,NH,333196,166599
242,318,1,183231,112388,2016,NJ,295619,147810
243,319,2,110838,176338,2016,NJ,287176,143589
244,320,3,127526,194596,2016,NJ,322122,161062
245,321,4,111532,211992,2016,NJ,323524,161763
246,322,5,172587,157690,2016,NJ,330277,165139
247,323,6,167895,91908,2016,NJ,259803,129902
248,324,7,148188,185850,2016,NJ,334038,167020
249,325,8,134733,32337,2016,NJ,167070,83536
250,326,9,162642,65376,2016,NJ,228018,114010
251,327,10,190856,26450,2016,NJ,217306,108654
252,328,11,130162,194299,2016,NJ,324461,162231
253,329,12,181430,92407,2016,NJ,273837,136919
254,332,1,181088,96879,2016,NM,277967,138984
255,333,2,85232,143515,2016,NM,228747,114374
256,334,3,170612,102730,2016,NM,273342,136672
257,337,1,0,158409,2016,NY,158409,79205
258,338,2,0,0,2016,NY,0,1
259,339,3,0,133954,2016,NY,133954,66978
260,340,4,0,111246,2016,NY,111246,55624
261,341,5,0,26791,2016,NY,26791,13396
262,342,6,0,43770,2016,NY,43770,21886
263,343,7,0,14941,2016,NY,14941,7471
264,344,8,0,0,2016,NY,0,1
265,345,9,0,0,2016,NY,0,1
266,346,10,0,46275,2016,NY,46275,23138
267,347,11,0,122606,2016,NY,122606,61304
268,348,12,0,49398,2016,NY,49398,24700
269,349,13,0,13129,2016,NY,13129,6565
270,350,14,0,26891,2016,NY,26891,13446
271,351,15,0,6129,2016,NY,6129,3065
272,352,16,0,0,2016,NY,0,1
273,353,17,0,0,2016,NY,0,1
274,354,18,0,111117,2016,NY,111117,55559
275,355,19,0,135905,2016,NY,135905,67953
276,356,20,0,83328,2016,NY,83328,41665
277,357,21,0,152597,2016,NY,152597,76299
278,358,22,0,113287,2016,NY,113287,56644
279,359,23,0,136964,2016,NY,136964,68483
280,360,24,0,150330,2016,NY,150330,75166
281,361,25,0,113840,2016,NY,113840,56921
282,362,26,0,56930,2016,NY,56930,28466
283,363,27,0,175509,2016,NY,175509,87755
284,367,1,240661,101567,2016,NC,342228,171115
285,368,2,169082,221485,2016,NC,390567,195284
286,369,3,106170,217531,2016,NC,323701,161851
287,370,4,279380,130161,2016,NC,409541,204771
288,371,5,147887,207625,2016,NC,355512,177757
289,372,6,143167,207983,2016,NC,351150,175576
290,373,7,135905,211801,2016,NC,347706,173854
291,374,8,133182,189863,2016,NC,323045,161523
292,375,9,139041,193452,2016,NC,332493,166247
293,376,10,128919,220825,2016,NC,349744,174873
294,377,11,129103,230405,2016,NC,359508,179755
295,378,12,234115,115185,2016,NC,349300,174651
296,379,13,156049,199443,2016,NC,355492,177747
297,383,1,0,233980,2016,ND,233980,116991
298,386,1,144644,210014,2016,OH,354658,177330
299,387,2,111694,221193,2016,OH,332887,166444
300,388,3,199791,91560,2016,OH,291351,145676
301,389,4,98981,210227,2016,OH,309208,154605
302,390,5,100392,244599,2016,OH,344991,172496
303,391,6,88780,213975,2016,OH,302755,151378
304,392,7,89638,198221,2016,OH,287859,143930
305,393,8,87794,223833,2016,OH,311627,155814
306,394,9,193966,88427,2016,OH,282393,141197
307,395,10,109981,215724,2016,OH,325705,162853
308,396,11,242917,59769,2016,OH,302686,151344
309,397,12,112638,251266,2016,OH,363904,181953
310,398,13,208610,99377,2016,OH,307987,153994
311,399,14,219191,0,2016,OH,219191,109596
312,400,15,222847,0,2016,OH,222847,111424
313,401,16,225794,0,2016,OH,225794,112898
314,405,1,0,1,2016,OK,1,1
315,406,2,62387,189839,2016,OK,252226,126114
316,407,3,63090,227525,2016,OK,290615,145308
317,408,4,76472,204143,2016,OK,280615,140308
318,409,5,103273,160184,2016,OK,263457,131729
319,413,1,225391,139756,2016,OR,365147,182574
320,414,2,106640,272952,2016,OR,379592,189797
321,415,3,274687,0,2016,OR,274687,137344
322,416,4,220628,157743,2016,OR,378371,189186
323,417,5,199505,160443,2016,OR,359948,179975
324,421,1,245791,53219,2016,PA,299010,149506
325,422,2,322514,35131,2016,PA,357645,178823
326,423,3,0,244893,2016,PA,244893,122447
327,424,4,113372,220628,2016,PA,334000,167001
328,425,5,101082,206761,2016,PA,307843,153922
329,426,6,155000,207469,2016,PA,362469,181235
330,427,7,153824,225678,2016,PA,379502,189752
331,428,8,173555,207263,2016,PA,380818,190410
332,429,9,107985,186580,2016,PA,294565,147283
333,430,10,89823,211282,2016,PA,301105,150553
334,431,11,113800,199421,2016,PA,313221,156611
335,432,12,137353,221851,2016,PA,359204,179603
336,433,13,239316,0,2016,PA,239316,119659
337,434,14,255293,87999,2016,PA,343292,171647
338,435,15,124129,190618,2016,PA,314747,157374
339,436,16,134586,168669,2016,PA,303255,151628
340,437,17,157734,135430,2016,PA,293164,146583
341,438,18,0,293684,2016,PA,293684,146843
342,442,1,130534,71023,2016,RI,201557,100779
343,443,2,133108,70301,2016,RI,203409,101705
344,446,1,110539,190410,2016,SC,300949,150475
345,447,2,105306,183746,2016,SC,289052,144527
346,448,3,72933,196325,2016,SC,269258,134630
347,449,4,91676,198648,2016,SC,290324,145163
348,450,5,105772,161669,2016,SC,267441,133721
349,451,6,177947,70099,2016,SC,248046,124024
350,452,7,103454,176468,2016,SC,279922,139962
351,456,1,132810,237163,2016,SD,369973,184987
352,459,1,39024,198293,2016,TN,237317,118659
353,460,2,68401,212455,2016,TN,280856,140429
354,461,3,76727,176613,2016,TN,253340,126671
355,462,4,89141,165796,2016,TN,254937,127469
356,463,5,171111,102433,2016,TN,273544,136773
357,464,6,61995,202234,2016,TN,264229,132115
358,465,7,65226,200407,2016,TN,265633,132817
359,466,8,70925,194386,2016,TN,265311,132656
360,467,9,171631,41123,2016,TN,212754,106378
361,470,1,62847,192434,2016,TX,255281,127641
362,471,2,100231,168692,2016,TX,268923,134462
363,472,3,109420,193684,2016,TX,303104,151553
364,473,4,0,216643,2016,TX,216643,108322
365,474,5,0,155469,2016,TX,155469,77735
366,475,6,106667,159444,2016,TX,266111,133056
367,476,7,111991,143542,2016,TX,255533,127767
368,477,8,0,236379,2016,TX,236379,118190
369,478,9,152032,36491,2016,TX,188523,94262
370,479,10,120170,179221,2016,TX,299391,149696
371,480,11,0,201871,2016,TX,201871,100936
372,481,12,76029,196482,2016,TX,272511,136256
373,482,13,0,199050,2016,TX,199050,99526
374,483,14,99054,160631,2016,TX,259685,129843
375,484,15,101712,66877,2016,TX,168589,84295
376,485,16,150228,0,2016,TX,150228,75115
377,486,17,86603,149417,2016,TX,236020,118011
378,487,18,150157,48306,2016,TX,198463,99232
379,488,19,0,176314,2016,TX,176314,88158
380,489,20,149640,0,2016,TX,149640,74821
381,490,21,129765,202967,2016,TX,332732,166367
382,491,22,123679,181864,2016,TX,305543,152772
383,492,23,107526,110577,2016,TX,218103,109052
384,493,24,108389,154845,2016,TX,263234,131618
385,494,25,117073,180988,2016,TX,298061,149031
386,495,26,94507,211730,2016,TX,306237,153119
387,496,27,88329,142251,2016,TX,230580,115291
388,497,28,122086,57740,2016,TX,179826,89914
389,498,29,95649,31646,2016,TX,127295,63648
390,499,30,170502,41518,2016,TX,212020,106011
391,500,31,103852,166060,2016,TX,269912,134957
392,501,32,0,162868,2016,TX,162868,81435
393,502,33,93147,33222,2016,TX,126369,63185
394,503,34,104638,62323,2016,TX,166961,83481
395,504,35,124612,62384,2016,TX,186996,93499
396,505,36,0,193675,2016,TX,193675,96838
397,508,1,73380,182925,2016,UT,256305,128153
398,509,2,93778,170524,2016,UT,264302,132152
399,510,3,75716,209589,2016,UT,285305,142653
400,511,4,113413,147597,2016,UT,261010,130506
401,516,1,192243,103637,2016,VT,295880,147941
402,518,1,140785,230213,2016,VA,370998,185500
403,519,2,119440,190475,2016,VA,309915,154958
404,520,3,208337,103289,2016,VA,311626,155814
405,521,4,200136,145731,2016,VA,345867,172934
406,522,5,148339,207758,2016,VA,356097,178049
407,523,6,112170,225471,2016,VA,337641,168821
408,524,7,160159,218057,2016,VA,378216,189109
409,525,8,246653,98387,2016,VA,345040,172521
410,526,9,87877,212838,2016,VA,300715,150358
411,527,10,187712,210791,2016,VA,398503,199252
412,528,11,247818,0,2016,VA,247818,123910
413,531,1,193619,155779,2016,WA,349398,174700
414,532,2,208314,117094,2016,WA,325408,162705
415,533,3,119820,193457,2016,WA,313277,156639
416,534,4,0,229919,2016,WA,229919,114960
417,535,5,130575,192959,2016,WA,323534,161768
418,536,6,201718,126116,2016,WA,327834,163918
419,537,7,378754,0,2016,WA,378754,189378
420,538,8,127720,193145,2016,WA,320865,160433
421,539,9,205165,76317,2016,WA,281482,140742
422,540,10,170460,120104,2016,WA,290564,145283
423,544,1,73534,163469,2016,WV,237003,118502
424,545,2,101207,140807,2016,WV,242014,121008
425,546,3,49708,140741,2016,WV,190449,95225
426,549,1,107003,230072,2016,WI,337075,168538
427,550,2,273537,124044,2016,WI,397581,198791
428,551,3,257401,0,2016,WI,257401,128701
429,552,4,220181,0,2016,WI,220181,110091
430,553,5,114477,260706,2016,WI,375183,187592
431,554,6,133072,204147,2016,WI,337219,168610
432,555,7,138643,223418,2016,WI,362061,181031
433,556,8,135682,227892,2016,WI,363574,181788
434,560,1,75466,156176,2016,WY,231642,115822
